States/UTs,Crime Head,18-30,30-45,45-60,60+,Total
Andhra Pradesh,1 - Murder (Section 302 IPC),813,885,565,48,2311
Andhra Pradesh,2 - Attempt to commit Murder (Section 307 IPC),1213,963,464,22,2662
Andhra Pradesh,3 - Culpable Homicide not amounting to Murder (Section 304 IPC),18,68,14,0,100
Andhra Pradesh,4 - Attempt to commit Culpable Homicide (Section 308 IPC),0,2,2,0,4
Andhra Pradesh,5 - Rape (Section 376 IPC),715,369,98,12,1194
Andhra Pradesh,5.1 - Custodial Rape,0,0,0,0,0
Andhra Pradesh,5.1.1 - Gang Rape,0,0,0,0,0
Andhra Pradesh,5.1.2 - Other Rape,0,0,0,0,0
Andhra Pradesh,5.2 - Rape other than Custodial,715,369,98,12,1194
Andhra Pradesh,5.2.1 - Gang Rape,15,4,1,0,20
Andhra Pradesh,5.2.2 - Other Rape,700,365,97,12,1174
Andhra Pradesh,6 - Attempt to commit Rape (Section 376/511 IPC),104,62,1,0,167
Andhra Pradesh,"7 - Kidnapping & Abduction_Total (Section 3,364,364A, 366-369 IPC)",820,514,134,2,1470
Andhra Pradesh,7.1 - Kidnapping & Abduction (Section 363 IPC),229,168,33,1,431
Andhra Pradesh,7.2 - Kidnaping & Abduction in order to Murder (Section 364 IPC),7,2,0,0,9
Andhra Pradesh,7.3 - Kidnapping for Ransom (Section 364A IPC),7,5,0,0,12
Andhra Pradesh,7.4 - Kidnapping & Abduction of Women to compel her for marriage (Section 366 IPC),315,108,27,0,450
Andhra Pradesh,7.5 - Other Kidnapping,262,231,74,1,568
Andhra Pradesh,"8 - Dacoity (Section 395,396-398 IPC)",167,138,17,0,322
Andhra Pradesh,8.1 - Dacoity with Murder (Section 396 IPC),5,1,0,0,6
Andhra Pradesh,8.2 - Other Dacoity,162,137,17,0,316
Andhra Pradesh,9 - Making Preparation and Assembly for committing Dacoity (Section 399 & 402 IPC),0,8,0,0,8
Andhra Pradesh,"10 - Robbery (Section 392 to 394, 397 and 398 IPC)",399,178,51,0,628
Andhra Pradesh,11 - Criminal Trespass/Burglary_Total (Section 453 to 460 IPC),3050,1779,455,38,5322
Andhra Pradesh,"11.1 - Criminal Trespass/Burglary (Section 455, 457 & 458 IPC)",2304,1293,312,37,3946
Andhra Pradesh,"11.2 - House Trespass & House Breaking (Section 453,454,456,459 & 460 IPC)",746,486,143,1,1376
Andhra Pradesh,12 - Theft (Section 379 to 382 IPC),7137,4642,1405,207,13391
Andhra Pradesh,12.1 - Auto Theft,2072,1176,396,14,3658
Andhra Pradesh,12.2 - Other Thefts,5065,3466,1009,193,9733
Andhra Pradesh,"13 - Unlawful Assembly (Section 143,144 & 145)",127,137,24,0,288
Andhra Pradesh,"14 - Riots (Section 147, 148, 149, 150 & 151 IPC)",3184,2627,988,69,6868
Andhra Pradesh,14.1 - Communal,123,44,19,0,186
Andhra Pradesh,14.2 - Industrial,0,31,0,0,31
Andhra Pradesh,14.3 - Political,775,796,409,8,1988
Andhra Pradesh,14.4 - Caste Conflict,31,17,7,0,55
Andhra Pradesh,14.4.1 - SC/STs Vs. Non-SCs/STs,31,17,7,0,55
Andhra Pradesh,14.4.2 - Other Caste Riots,0,0,0,0,0
Andhra Pradesh,14.5 - Agrarian,0,0,0,0,0
Andhra Pradesh,14.6 - Students,0,0,0,0,0
Andhra Pradesh,14.7 - Sectarian,0,0,0,0,0
Andhra Pradesh,14.8 - Other Riots,2255,1739,553,61,4608
Andhra Pradesh,15 - Criminal Breach of Trust (Section 406 to 409 IPC),362,568,202,36,1168
Andhra Pradesh,16 - Cheating (Section 420 IPC),1744,3357,1799,127,7027
Andhra Pradesh,"17 - Forgery (Section 465, 468 & 471 IPC)",40,88,53,18,199
Andhra Pradesh,"18 - Counterfeiting (Section 231-235,237-240, 242-243, 255 and 489-A to 489-E IPC)",57,74,13,1,145
Andhra Pradesh,"18.1 - Offences related to Counterfeit Coin (Section 231-235,237, 238-240 & 242-243 IPC)",2,4,0,0,6
Andhra Pradesh,18.2 - Counterfeiting Government Stamp (Section 255 IPC),0,0,0,0,0
Andhra Pradesh,18.3 - Counterfeit currency & Bank notes (Section 489-A to 489-E IPC),55,70,13,1,139
Andhra Pradesh,18.3.1 - Counterfeiting currency notes or Bank notes (Section 489A IPC),25,37,6,1,69
Andhra Pradesh,18.3.2 - Using forged or counterfeit currency/Bank notes (Section 489B IPC),11,19,2,0,32
Andhra Pradesh,18.3.3 - Possession of forged or counterfeiting currency / Bank notes (Section 489C IPC),17,14,5,0,36
Andhra Pradesh,18.3.4 - Make/Possess materials for forging or counterfeiting currency/Bank notes (Section 489D IPC),2,0,0,0,2
Andhra Pradesh,18.3.5 - Make/Use documents resembling currency notes/Bank notes (Section 489 E IPC),0,0,0,0,0
Andhra Pradesh,19 - Arson (Section 435-436 & 438 IPC),132,274,93,2,501
Andhra Pradesh,"20 - Grievous Hurt (Section 325,326,326A & 326 B IPC)",525,532,164,17,1238
Andhra Pradesh,20.1 - Grievous Hurt (Section 325 & 326 IPC),516,532,163,16,1227
Andhra Pradesh,20.2 - Acid attack (Section 326A IPC),5,0,1,1,7
Andhra Pradesh,20.3 - Attempt to Acid Attack (Section 326B IPC),4,0,0,0,4
Andhra Pradesh,21 - Dowry Deaths (Section 304-B IPC),180,236,106,9,531
Andhra Pradesh,22 - Assault on women with intent to outrage her Modesty (Section 354 IPC),2361,1948,559,12,4880
Andhra Pradesh,22.1 - Sexual Harassment (Section 354A IPC),514,433,108,2,1057
Andhra Pradesh,22.2 - Assault on women with intent to Disrobe (Section 354B IPC),214,129,31,1,375
Andhra Pradesh,22.3 - Voyeurism (Section 354C IPC),46,33,6,0,85
Andhra Pradesh,22.4 - Stalking (Section 354D IPC),265,202,42,0,509
Andhra Pradesh,22.5 - Others,1322,1151,372,9,2854
Andhra Pradesh,23 - Insult to the Modesty of Women (Section 509 IPC),1501,1192,241,62,2996
Andhra Pradesh,23.1 - At Office premises,0,2,0,0,2
Andhra Pradesh,23.2 - Places related to work other than Office,49,55,3,0,107
Andhra Pradesh,23.3 - In Public Transport system,55,12,1,0,68
Andhra Pradesh,23.4 - in Other Places,1397,1123,237,62,2819
Andhra Pradesh,24 - Cruelty by Husband or his Relatives (Section 498-A IPC),2994,4311,1763,202,9270
Andhra Pradesh,25 - Importation of Girls from Foreign Country (Section 366-B IPC),0,0,0,0,0
Andhra Pradesh,26 - Causing Death by Negligence (Section 304-A IPC),2324,3083,1284,49,6740
Andhra Pradesh,26.1 - Deaths due to negligent driving/act,2300,3009,1253,49,6611
Andhra Pradesh,26.2 - Deaths due to Other Causes,24,74,31,0,129
Andhra Pradesh,"27 - Offences against State (Section 121, 121A, 122, 123, 124-A IPC)",0,0,0,0,0
Andhra Pradesh,27.1 - Sedition (Section 124A IPC),0,0,0,0,0
Andhra Pradesh,27.2 - Other offences against State,0,0,0,0,0
Andhra Pradesh,28 - Offences promoting enmity between different groups (Section 153A & 153B IPC),25,11,6,0,42
Andhra Pradesh,28.1 - Promoting enmity on ground of religion race and place of Birth (Section 153A IPC),25,11,6,0,42
Andhra Pradesh,28.2 - Imputation & assertions prejudicial to national integration (Section 153B IPC),0,0,0,0,0
Andhra Pradesh,29 - Extortion (Section 384 - 389 IPC),146,138,44,0,328
Andhra Pradesh,30 - Disclosure of Identity of Victims (Section 228 A IPC),0,0,0,0,0
Andhra Pradesh,31 - Incidence of Rash Driving (Section 279 IPC Read with 337 & 338),5244,5660,2210,371,13485
Andhra Pradesh,32 - Human Trafficking (Section 370 & 370A IPC),4,5,1,0,10
Andhra Pradesh,33 - Unnatural Offences U/s 377 IPC,1,0,0,0,1
Andhra Pradesh,34 - Other IPC crimes,32577,35138,13089,1109,81913
Andhra Pradesh,35 - Total Cognizable IPC crimes,67964,68987,25845,2413,165209
Arunachal Pradesh,1 - Murder (Section 302 IPC),89,68,7,0,164
Arunachal Pradesh,2 - Attempt to commit Murder (Section 307 IPC),32,29,9,0,70
Arunachal Pradesh,3 - Culpable Homicide not amounting to Murder (Section 304 IPC),2,1,0,0,3
Arunachal Pradesh,4 - Attempt to commit Culpable Homicide (Section 308 IPC),0,0,0,0,0
Arunachal Pradesh,5 - Rape (Section 376 IPC),52,32,4,0,88
Arunachal Pradesh,5.1 - Custodial Rape,3,1,0,0,4
Arunachal Pradesh,5.1.1 - Gang Rape,0,0,0,0,0
Arunachal Pradesh,5.1.2 - Other Rape,3,1,0,0,4
Arunachal Pradesh,5.2 - Rape other than Custodial,49,31,4,0,84
Arunachal Pradesh,5.2.1 - Gang Rape,7,0,0,0,7
Arunachal Pradesh,5.2.2 - Other Rape,42,31,4,0,77
Arunachal Pradesh,6 - Attempt to commit Rape (Section 376/511 IPC),8,3,2,0,13
Arunachal Pradesh,"7 - Kidnapping & Abduction_Total (Section 3,364,364A, 366-369 IPC)",91,59,4,0,154
Arunachal Pradesh,7.1 - Kidnapping & Abduction (Section 363 IPC),17,10,0,0,27
Arunachal Pradesh,7.2 - Kidnaping & Abduction in order to Murder (Section 364 IPC),2,0,0,0,2
Arunachal Pradesh,7.3 - Kidnapping for Ransom (Section 364A IPC),7,2,0,0,9
Arunachal Pradesh,7.4 - Kidnapping & Abduction of Women to compel her for marriage (Section 366 IPC),8,11,1,0,20
Arunachal Pradesh,7.5 - Other Kidnapping,57,36,3,0,96
Arunachal Pradesh,"8 - Dacoity (Section 395,396-398 IPC)",7,2,0,0,9
Arunachal Pradesh,8.1 - Dacoity with Murder (Section 396 IPC),0,0,0,0,0
Arunachal Pradesh,8.2 - Other Dacoity,7,2,0,0,9
Arunachal Pradesh,9 - Making Preparation and Assembly for committing Dacoity (Section 399 & 402 IPC),0,0,0,0,0
Arunachal Pradesh,"10 - Robbery (Section 392 to 394, 397 and 398 IPC)",65,23,7,0,95
Arunachal Pradesh,11 - Criminal Trespass/Burglary_Total (Section 453 to 460 IPC),89,21,3,0,113
Arunachal Pradesh,"11.1 - Criminal Trespass/Burglary (Section 455, 457 & 458 IPC)",72,21,3,0,96
Arunachal Pradesh,"11.2 - House Trespass & House Breaking (Section 453,454,456,459 & 460 IPC)",17,0,0,0,17
Arunachal Pradesh,12 - Theft (Section 379 to 382 IPC),226,92,7,0,325
Arunachal Pradesh,12.1 - Auto Theft,52,16,0,0,68
Arunachal Pradesh,12.2 - Other Thefts,174,76,7,0,257
Arunachal Pradesh,"13 - Unlawful Assembly (Section 143,144 & 145)",12,9,0,0,21
Arunachal Pradesh,"14 - Riots (Section 147, 148, 149, 150 & 151 IPC)",73,49,15,0,137
Arunachal Pradesh,14.1 - Communal,11,3,0,0,14
Arunachal Pradesh,14.2 - Industrial,0,0,0,0,0
Arunachal Pradesh,14.3 - Political,10,23,12,0,45
Arunachal Pradesh,14.4 - Caste Conflict,0,0,0,0,0
Arunachal Pradesh,14.4.1 - SC/STs Vs. Non-SCs/STs,0,0,0,0,0
Arunachal Pradesh,14.4.2 - Other Caste Riots,0,0,0,0,0
Arunachal Pradesh,14.5 - Agrarian,0,0,0,0,0
Arunachal Pradesh,14.6 - Students,5,0,0,0,5
Arunachal Pradesh,14.7 - Sectarian,0,0,0,0,0
Arunachal Pradesh,14.8 - Other Riots,47,23,3,0,73
Arunachal Pradesh,15 - Criminal Breach of Trust (Section 406 to 409 IPC),19,9,2,0,30
Arunachal Pradesh,16 - Cheating (Section 420 IPC),39,39,9,0,87
Arunachal Pradesh,"17 - Forgery (Section 465, 468 & 471 IPC)",5,5,0,0,10
Arunachal Pradesh,"18 - Counterfeiting (Section 231-235,237-240, 242-243, 255 and 489-A to 489-E IPC)",0,0,0,0,0
Arunachal Pradesh,"18.1 - Offences related to Counterfeit Coin (Section 231-235,237, 238-240 & 242-243 IPC)",0,0,0,0,0
Arunachal Pradesh,18.2 - Counterfeiting Government Stamp (Section 255 IPC),0,0,0,0,0
Arunachal Pradesh,18.3 - Counterfeit currency & Bank notes (Section 489-A to 489-E IPC),0,0,0,0,0
Arunachal Pradesh,18.3.1 - Counterfeiting currency notes or Bank notes (Section 489A IPC),0,0,0,0,0
Arunachal Pradesh,18.3.2 - Using forged or counterfeit currency/Bank notes (Section 489B IPC),0,0,0,0,0
Arunachal Pradesh,18.3.3 - Possession of forged or counterfeiting currency / Bank notes (Section 489C IPC),0,0,0,0,0
Arunachal Pradesh,18.3.4 - Make/Possess materials for forging or counterfeiting currency/Bank notes (Section 489D IPC),0,0,0,0,0
Arunachal Pradesh,18.3.5 - Make/Use documents resembling currency notes/Bank notes (Section 489 E IPC),0,0,0,0,0
Arunachal Pradesh,19 - Arson (Section 435-436 & 438 IPC),17,6,0,0,23
Arunachal Pradesh,"20 - Grievous Hurt (Section 325,326,326A & 326 B IPC)",198,89,25,0,312
Arunachal Pradesh,20.1 - Grievous Hurt (Section 325 & 326 IPC),198,89,25,0,312
Arunachal Pradesh,20.2 - Acid attack (Section 326A IPC),0,0,0,0,0
Arunachal Pradesh,20.3 - Attempt to Acid Attack (Section 326B IPC),0,0,0,0,0
Arunachal Pradesh,21 - Dowry Deaths (Section 304-B IPC),1,0,0,0,1
Arunachal Pradesh,22 - Assault on women with intent to outrage her Modesty (Section 354 IPC),91,61,6,0,158
Arunachal Pradesh,22.1 - Sexual Harassment (Section 354A IPC),13,13,0,0,26
Arunachal Pradesh,22.2 - Assault on women with intent to Disrobe (Section 354B IPC),0,0,0,0,0
Arunachal Pradesh,22.3 - Voyeurism (Section 354C IPC),3,3,0,0,6
Arunachal Pradesh,22.4 - Stalking (Section 354D IPC),0,0,0,0,0
Arunachal Pradesh,22.5 - Others,75,45,6,0,126
Arunachal Pradesh,23 - Insult to the Modesty of Women (Section 509 IPC),2,1,0,0,3
Arunachal Pradesh,23.1 - At Office premises,0,0,0,0,0
Arunachal Pradesh,23.2 - Places related to work other than Office,0,0,0,0,0
Arunachal Pradesh,23.3 - In Public Transport system,0,0,0,0,0
Arunachal Pradesh,23.4 - in Other Places,2,1,0,0,3
Arunachal Pradesh,24 - Cruelty by Husband or his Relatives (Section 498-A IPC),14,24,6,0,44
Arunachal Pradesh,25 - Importation of Girls from Foreign Country (Section 366-B IPC),0,0,0,0,0
Arunachal Pradesh,26 - Causing Death by Negligence (Section 304-A IPC),21,11,5,0,37
Arunachal Pradesh,26.1 - Deaths due to negligent driving/act,21,10,4,0,35
Arunachal Pradesh,26.2 - Deaths due to Other Causes,0,1,1,0,2
Arunachal Pradesh,"27 - Offences against State (Section 121, 121A, 122, 123, 124-A IPC)",0,0,0,0,0
Arunachal Pradesh,27.1 - Sedition (Section 124A IPC),0,0,0,0,0
Arunachal Pradesh,27.2 - Other offences against State,0,0,0,0,0
Arunachal Pradesh,28 - Offences promoting enmity between different groups (Section 153A & 153B IPC),0,0,0,0,0
Arunachal Pradesh,28.1 - Promoting enmity on ground of religion race and place of Birth (Section 153A IPC),0,0,0,0,0
Arunachal Pradesh,28.2 - Imputation & assertions prejudicial to national integration (Section 153B IPC),0,0,0,0,0
Arunachal Pradesh,29 - Extortion (Section 384 - 389 IPC),115,39,6,0,160
Arunachal Pradesh,30 - Disclosure of Identity of Victims (Section 228 A IPC),0,0,0,0,0
Arunachal Pradesh,31 - Incidence of Rash Driving (Section 279 IPC Read with 337 & 338),54,15,1,0,70
Arunachal Pradesh,32 - Human Trafficking (Section 370 & 370A IPC),0,0,0,0,0
Arunachal Pradesh,33 - Unnatural Offences U/s 377 IPC,0,0,0,0,0
Arunachal Pradesh,34 - Other IPC crimes,504,334,73,4,915
Arunachal Pradesh,35 - Total Cognizable IPC crimes,1826,1021,191,4,3042
Assam,1 - Murder (Section 302 IPC),1384,2062,154,0,3600
Assam,2 - Attempt to commit Murder (Section 307 IPC),526,1013,188,0,1727
Assam,3 - Culpable Homicide not amounting to Murder (Section 304 IPC),27,104,20,0,151
Assam,4 - Attempt to commit Culpable Homicide (Section 308 IPC),2,12,0,0,14
Assam,5 - Rape (Section 376 IPC),1398,2017,200,0,3615
Assam,5.1 - Custodial Rape,0,0,0,0,0
Assam,5.1.1 - Gang Rape,0,0,0,0,0
Assam,5.1.2 - Other Rape,0,0,0,0,0
Assam,5.2 - Rape other than Custodial,1398,2017,200,0,3615
Assam,5.2.1 - Gang Rape,17,25,2,0,44
Assam,5.2.2 - Other Rape,1381,1992,198,0,3571
Assam,6 - Attempt to commit Rape (Section 376/511 IPC),65,135,25,0,225
Assam,"7 - Kidnapping & Abduction_Total (Section 3,364,364A, 366-369 IPC)",2329,4663,887,0,7879
Assam,7.1 - Kidnapping & Abduction (Section 363 IPC),0,0,0,0,0
Assam,7.2 - Kidnaping & Abduction in order to Murder (Section 364 IPC),0,6,0,0,6
Assam,7.3 - Kidnapping for Ransom (Section 364A IPC),25,20,4,0,49
Assam,7.4 - Kidnapping & Abduction of Women to compel her for marriage (Section 366 IPC),1905,3880,769,0,6554
Assam,7.5 - Other Kidnapping,399,757,114,0,1270
Assam,"8 - Dacoity (Section 395,396-398 IPC)",225,398,39,0,662
Assam,8.1 - Dacoity with Murder (Section 396 IPC),0,1,0,0,1
Assam,8.2 - Other Dacoity,225,397,39,0,661
Assam,9 - Making Preparation and Assembly for committing Dacoity (Section 399 & 402 IPC),5,23,1,0,29
Assam,"10 - Robbery (Section 392 to 394, 397 and 398 IPC)",601,1385,182,0,2168
Assam,11 - Criminal Trespass/Burglary_Total (Section 453 to 460 IPC),1932,3758,707,0,6397
Assam,"11.1 - Criminal Trespass/Burglary (Section 455, 457 & 458 IPC)",1763,3241,626,0,5630
Assam,"11.2 - House Trespass & House Breaking (Section 453,454,456,459 & 460 IPC)",169,517,81,0,767
Assam,12 - Theft (Section 379 to 382 IPC),6442,11368,1159,0,18969
Assam,12.1 - Auto Theft,1841,3074,285,0,5200
Assam,12.2 - Other Thefts,4601,8294,874,0,13769
Assam,"13 - Unlawful Assembly (Section 143,144 & 145)",403,748,157,0,1308
Assam,"14 - Riots (Section 147, 148, 149, 150 & 151 IPC)",1899,3123,639,0,5661
Assam,14.1 - Communal,0,0,0,0,0
Assam,14.2 - Industrial,0,0,0,0,0
Assam,14.3 - Political,0,3,0,0,3
Assam,14.4 - Caste Conflict,0,0,0,0,0
Assam,14.4.1 - SC/STs Vs. Non-SCs/STs,0,0,0,0,0
Assam,14.4.2 - Other Caste Riots,0,0,0,0,0
Assam,14.5 - Agrarian,0,0,0,0,0
Assam,14.6 - Students,0,0,0,0,0
Assam,14.7 - Sectarian,0,0,0,0,0
Assam,14.8 - Other Riots,1899,3120,639,0,5658
Assam,15 - Criminal Breach of Trust (Section 406 to 409 IPC),1030,1770,525,0,3325
Assam,16 - Cheating (Section 420 IPC),1129,2444,644,0,4217
Assam,"17 - Forgery (Section 465, 468 & 471 IPC)",18,66,6,0,90
Assam,"18 - Counterfeiting (Section 231-235,237-240, 242-243, 255 and 489-A to 489-E IPC)",31,109,13,0,153
Assam,"18.1 - Offences related to Counterfeit Coin (Section 231-235,237, 238-240 & 242-243 IPC)",0,0,0,0,0
Assam,18.2 - Counterfeiting Government Stamp (Section 255 IPC),0,0,0,0,0
Assam,18.3 - Counterfeit currency & Bank notes (Section 489-A to 489-E IPC),31,109,13,0,153
Assam,18.3.1 - Counterfeiting currency notes or Bank notes (Section 489A IPC),31,109,13,0,153
Assam,18.3.2 - Using forged or counterfeit currency/Bank notes (Section 489B IPC),0,0,0,0,0
Assam,18.3.3 - Possession of forged or counterfeiting currency / Bank notes (Section 489C IPC),0,0,0,0,0
Assam,18.3.4 - Make/Possess materials for forging or counterfeiting currency/Bank notes (Section 489D IPC),0,0,0,0,0
Assam,18.3.5 - Make/Use documents resembling currency notes/Bank notes (Section 489 E IPC),0,0,0,0,0
Assam,19 - Arson (Section 435-436 & 438 IPC),898,2041,161,0,3100
Assam,"20 - Grievous Hurt (Section 325,326,326A & 326 B IPC)",4034,5809,1678,0,11521
Assam,20.1 - Grievous Hurt (Section 325 & 326 IPC),4034,5809,1678,0,11521
Assam,20.2 - Acid attack (Section 326A IPC),0,0,0,0,0
Assam,20.3 - Attempt to Acid Attack (Section 326B IPC),0,0,0,0,0
Assam,21 - Dowry Deaths (Section 304-B IPC),33,202,49,0,284
Assam,22 - Assault on women with intent to outrage her Modesty (Section 354 IPC),1144,2045,577,0,3766
Assam,22.1 - Sexual Harassment (Section 354A IPC),152,279,27,0,458
Assam,22.2 - Assault on women with intent to Disrobe (Section 354B IPC),106,361,149,0,616
Assam,22.3 - Voyeurism (Section 354C IPC),0,0,0,0,0
Assam,22.4 - Stalking (Section 354D IPC),0,0,0,0,0
Assam,22.5 - Others,886,1405,401,0,2692
Assam,23 - Insult to the Modesty of Women (Section 509 IPC),0,1,0,0,1
Assam,23.1 - At Office premises,0,0,0,0,0
Assam,23.2 - Places related to work other than Office,0,1,0,0,1
Assam,23.3 - In Public Transport system,0,0,0,0,0
Assam,23.4 - in Other Places,0,0,0,0,0
Assam,24 - Cruelty by Husband or his Relatives (Section 498-A IPC),3256,8196,1508,0,12960
Assam,25 - Importation of Girls from Foreign Country (Section 366-B IPC),0,1,0,0,1
Assam,26 - Causing Death by Negligence (Section 304-A IPC),1118,1942,358,0,3418
Assam,26.1 - Deaths due to negligent driving/act,261,524,56,0,841
Assam,26.2 - Deaths due to Other Causes,857,1418,302,0,2577
Assam,"27 - Offences against State (Section 121, 121A, 122, 123, 124-A IPC)",17,31,9,0,57
Assam,27.1 - Sedition (Section 124A IPC),0,1,0,0,1
Assam,27.2 - Other offences against State,17,30,9,0,56
Assam,28 - Offences promoting enmity between different groups (Section 153A & 153B IPC),0,0,0,0,0
Assam,28.1 - Promoting enmity on ground of religion race and place of Birth (Section 153A IPC),0,0,0,0,0
Assam,28.2 - Imputation & assertions prejudicial to national integration (Section 153B IPC),0,0,0,0,0
Assam,29 - Extortion (Section 384 - 389 IPC),435,635,162,0,1232
Assam,30 - Disclosure of Identity of Victims (Section 228 A IPC),0,0,0,0,0
Assam,31 - Incidence of Rash Driving (Section 279 IPC Read with 337 & 338),1448,1532,229,0,3209
Assam,32 - Human Trafficking (Section 370 & 370A IPC),15,48,5,0,68
Assam,33 - Unnatural Offences U/s 377 IPC,0,0,0,0,0
Assam,34 - Other IPC crimes,15093,26042,5793,2,46930
Assam,35 - Total Cognizable IPC crimes,46937,83723,16075,2,146737
Bihar,1 - Murder (Section 302 IPC),2389,2208,773,44,5414
Bihar,2 - Attempt to commit Murder (Section 307 IPC),2760,2278,840,37,5915
Bihar,3 - Culpable Homicide not amounting to Murder (Section 304 IPC),151,89,44,9,293
Bihar,4 - Attempt to commit Culpable Homicide (Section 308 IPC),325,314,183,11,833
Bihar,5 - Rape (Section 376 IPC),826,274,41,0,1141
Bihar,5.1 - Custodial Rape,0,0,0,0,0
Bihar,5.1.1 - Gang Rape,0,0,0,0,0
Bihar,5.1.2 - Other Rape,0,0,0,0,0
Bihar,5.2 - Rape other than Custodial,826,274,41,0,1141
Bihar,5.2.1 - Gang Rape,40,7,0,0,47
Bihar,5.2.2 - Other Rape,786,267,41,0,1094
Bihar,6 - Attempt to commit Rape (Section 376/511 IPC),338,101,28,5,472
Bihar,"7 - Kidnapping & Abduction_Total (Section 3,364,364A, 366-369 IPC)",4963,1834,458,13,7268
Bihar,7.1 - Kidnapping & Abduction (Section 363 IPC),354,296,70,0,720
Bihar,7.2 - Kidnaping & Abduction in order to Murder (Section 364 IPC),483,268,68,8,827
Bihar,7.3 - Kidnapping for Ransom (Section 364A IPC),84,47,2,0,133
Bihar,7.4 - Kidnapping & Abduction of Women to compel her for marriage (Section 366 IPC),3578,959,273,5,4815
Bihar,7.5 - Other Kidnapping,464,264,45,0,773
Bihar,"8 - Dacoity (Section 395,396-398 IPC)",1109,789,195,3,2096
Bihar,8.1 - Dacoity with Murder (Section 396 IPC),13,11,0,0,24
Bihar,8.2 - Other Dacoity,1096,778,195,3,2072
Bihar,9 - Making Preparation and Assembly for committing Dacoity (Section 399 & 402 IPC),164,78,4,0,246
Bihar,"10 - Robbery (Section 392 to 394, 397 and 398 IPC)",1987,848,217,12,3064
Bihar,11 - Criminal Trespass/Burglary_Total (Section 453 to 460 IPC),2622,1055,369,20,4066
Bihar,"11.1 - Criminal Trespass/Burglary (Section 455, 457 & 458 IPC)",2521,996,365,20,3902
Bihar,"11.2 - House Trespass & House Breaking (Section 453,454,456,459 & 460 IPC)",101,59,4,0,164
Bihar,12 - Theft (Section 379 to 382 IPC),9891,4769,1290,112,16062
Bihar,12.1 - Auto Theft,3931,1859,298,84,6172
Bihar,12.2 - Other Thefts,5960,2910,992,28,9890
Bihar,"13 - Unlawful Assembly (Section 143,144 & 145)",406,600,636,5,1647
Bihar,"14 - Riots (Section 147, 148, 149, 150 & 151 IPC)",28211,20196,4606,143,53156
Bihar,14.1 - Communal,281,86,15,2,384
Bihar,14.2 - Industrial,0,0,0,0,0
Bihar,14.3 - Political,13,9,3,0,25
Bihar,14.4 - Caste Conflict,45,5,0,0,50
Bihar,14.4.1 - SC/STs Vs. Non-SCs/STs,0,0,0,0,0
Bihar,14.4.2 - Other Caste Riots,45,5,0,0,50
Bihar,14.5 - Agrarian,321,461,204,9,995
Bihar,14.6 - Students,58,0,0,0,58
Bihar,14.7 - Sectarian,0,0,0,0,0
Bihar,14.8 - Other Riots,27493,19635,4384,132,51644
Bihar,15 - Criminal Breach of Trust (Section 406 to 409 IPC),603,644,282,0,1529
Bihar,16 - Cheating (Section 420 IPC),1677,2422,1152,78,5329
Bihar,"17 - Forgery (Section 465, 468 & 471 IPC)",315,508,203,24,1050
Bihar,"18 - Counterfeiting (Section 231-235,237-240, 242-243, 255 and 489-A to 489-E IPC)",154,105,56,5,320
Bihar,"18.1 - Offences related to Counterfeit Coin (Section 231-235,237, 238-240 & 242-243 IPC)",140,92,56,5,293
Bihar,18.2 - Counterfeiting Government Stamp (Section 255 IPC),0,0,0,0,0
Bihar,18.3 - Counterfeit currency & Bank notes (Section 489-A to 489-E IPC),14,13,0,0,27
Bihar,18.3.1 - Counterfeiting currency notes or Bank notes (Section 489A IPC),9,9,0,0,18
Bihar,18.3.2 - Using forged or counterfeit currency/Bank notes (Section 489B IPC),4,2,0,0,6
Bihar,18.3.3 - Possession of forged or counterfeiting currency / Bank notes (Section 489C IPC),1,2,0,0,3
Bihar,18.3.4 - Make/Possess materials for forging or counterfeiting currency/Bank notes (Section 489D IPC),0,0,0,0,0
Bihar,18.3.5 - Make/Use documents resembling currency notes/Bank notes (Section 489 E IPC),0,0,0,0,0
Bihar,19 - Arson (Section 435-436 & 438 IPC),373,343,118,5,839
Bihar,"20 - Grievous Hurt (Section 325,326,326A & 326 B IPC)",10950,8930,3720,153,23753
Bihar,20.1 - Grievous Hurt (Section 325 & 326 IPC),10945,8930,3720,153,23748
Bihar,20.2 - Acid attack (Section 326A IPC),5,0,0,0,5
Bihar,20.3 - Attempt to Acid Attack (Section 326B IPC),0,0,0,0,0
Bihar,21 - Dowry Deaths (Section 304-B IPC),1229,801,340,14,2384
Bihar,22 - Assault on women with intent to outrage her Modesty (Section 354 IPC),487,181,44,8,720
Bihar,22.1 - Sexual Harassment (Section 354A IPC),251,79,32,0,362
Bihar,22.2 - Assault on women with intent to Disrobe (Section 354B IPC),58,29,4,0,91
Bihar,22.3 - Voyeurism (Section 354C IPC),5,0,0,0,5
Bihar,22.4 - Stalking (Section 354D IPC),5,1,0,0,6
Bihar,22.5 - Others,168,72,8,8,256
Bihar,23 - Insult to the Modesty of Women (Section 509 IPC),45,26,0,0,71
Bihar,23.1 - At Office premises,0,0,0,0,0
Bihar,23.2 - Places related to work other than Office,0,0,0,0,0
Bihar,23.3 - In Public Transport system,0,0,0,0,0
Bihar,23.4 - in Other Places,45,26,0,0,71
Bihar,24 - Cruelty by Husband or his Relatives (Section 498-A IPC),3509,1747,719,22,5997
Bihar,25 - Importation of Girls from Foreign Country (Section 366-B IPC),10,9,0,0,19
Bihar,26 - Causing Death by Negligence (Section 304-A IPC),2987,1188,413,40,4628
Bihar,26.1 - Deaths due to negligent driving/act,2779,1049,336,40,4204
Bihar,26.2 - Deaths due to Other Causes,208,139,77,0,424
Bihar,"27 - Offences against State (Section 121, 121A, 122, 123, 124-A IPC)",15,20,0,0,35
Bihar,27.1 - Sedition (Section 124A IPC),12,16,0,0,28
Bihar,27.2 - Other offences against State,3,4,0,0,7
Bihar,28 - Offences promoting enmity between different groups (Section 153A & 153B IPC),0,0,0,0,0
Bihar,28.1 - Promoting enmity on ground of religion race and place of Birth (Section 153A IPC),0,0,0,0,0
Bihar,28.2 - Imputation & assertions prejudicial to national integration (Section 153B IPC),0,0,0,0,0
Bihar,29 - Extortion (Section 384 - 389 IPC),605,390,147,0,1142
Bihar,30 - Disclosure of Identity of Victims (Section 228 A IPC),0,0,0,0,0
Bihar,31 - Incidence of Rash Driving (Section 279 IPC Read with 337 & 338),2187,969,280,0,3436
Bihar,32 - Human Trafficking (Section 370 & 370A IPC),27,31,21,0,79
Bihar,33 - Unnatural Offences U/s 377 IPC,2,3,0,0,5
Bihar,34 - Other IPC crimes,59812,28904,10842,787,100345
Bihar,35 - Total Cognizable IPC crimes,141129,82654,28021,1550,253354
Chhattisgarh,1 - Murder (Section 302 IPC),639,633,259,34,1565
Chhattisgarh,2 - Attempt to commit Murder (Section 307 IPC),511,561,163,12,1247
Chhattisgarh,3 - Culpable Homicide not amounting to Murder (Section 304 IPC),20,23,6,0,49
Chhattisgarh,4 - Attempt to commit Culpable Homicide (Section 308 IPC),0,0,0,0,0
Chhattisgarh,5 - Rape (Section 376 IPC),1101,374,100,13,1588
Chhattisgarh,5.1 - Custodial Rape,0,0,0,0,0
Chhattisgarh,5.1.1 - Gang Rape,0,0,0,0,0
Chhattisgarh,5.1.2 - Other Rape,0,0,0,0,0
Chhattisgarh,5.2 - Rape other than Custodial,1101,374,100,13,1588
Chhattisgarh,5.2.1 - Gang Rape,157,25,6,1,189
Chhattisgarh,5.2.2 - Other Rape,944,349,94,12,1399
Chhattisgarh,6 - Attempt to commit Rape (Section 376/511 IPC),13,6,2,0,21
Chhattisgarh,"7 - Kidnapping & Abduction_Total (Section 3,364,364A, 366-369 IPC)",786,258,72,0,1116
Chhattisgarh,7.1 - Kidnapping & Abduction (Section 363 IPC),389,117,33,0,539
Chhattisgarh,7.2 - Kidnaping & Abduction in order to Murder (Section 364 IPC),8,7,1,0,16
Chhattisgarh,7.3 - Kidnapping for Ransom (Section 364A IPC),3,11,0,0,14
Chhattisgarh,7.4 - Kidnapping & Abduction of Women to compel her for marriage (Section 366 IPC),182,46,8,0,236
Chhattisgarh,7.5 - Other Kidnapping,204,77,30,0,311
Chhattisgarh,"8 - Dacoity (Section 395,396-398 IPC)",108,75,4,0,187
Chhattisgarh,8.1 - Dacoity with Murder (Section 396 IPC),1,5,0,0,6
Chhattisgarh,8.2 - Other Dacoity,107,70,4,0,181
Chhattisgarh,9 - Making Preparation and Assembly for committing Dacoity (Section 399 & 402 IPC),24,9,0,0,33
Chhattisgarh,"10 - Robbery (Section 392 to 394, 397 and 398 IPC)",438,144,50,0,632
Chhattisgarh,11 - Criminal Trespass/Burglary_Total (Section 453 to 460 IPC),1208,588,169,9,1974
Chhattisgarh,"11.1 - Criminal Trespass/Burglary (Section 455, 457 & 458 IPC)",912,433,123,5,1473
Chhattisgarh,"11.2 - House Trespass & House Breaking (Section 453,454,456,459 & 460 IPC)",296,155,46,4,501
Chhattisgarh,12 - Theft (Section 379 to 382 IPC),2265,1123,358,47,3793
Chhattisgarh,12.1 - Auto Theft,889,449,120,0,1458
Chhattisgarh,12.2 - Other Thefts,1376,674,238,47,2335
Chhattisgarh,"13 - Unlawful Assembly (Section 143,144 & 145)",240,73,54,0,367
Chhattisgarh,"14 - Riots (Section 147, 148, 149, 150 & 151 IPC)",1951,1552,688,102,4293
Chhattisgarh,14.1 - Communal,0,0,0,0,0
Chhattisgarh,14.2 - Industrial,4,2,0,0,6
Chhattisgarh,14.3 - Political,9,12,2,2,25
Chhattisgarh,14.4 - Caste Conflict,370,252,90,4,716
Chhattisgarh,14.4.1 - SC/STs Vs. Non-SCs/STs,21,12,2,0,35
Chhattisgarh,14.4.2 - Other Caste Riots,349,240,88,4,681
Chhattisgarh,14.5 - Agrarian,21,15,5,1,42
Chhattisgarh,14.6 - Students,5,0,0,0,5
Chhattisgarh,14.7 - Sectarian,0,0,0,0,0
Chhattisgarh,14.8 - Other Riots,1542,1271,591,95,3499
Chhattisgarh,15 - Criminal Breach of Trust (Section 406 to 409 IPC),90,82,34,0,206
Chhattisgarh,16 - Cheating (Section 420 IPC),361,418,226,15,1020
Chhattisgarh,"17 - Forgery (Section 465, 468 & 471 IPC)",31,40,1,0,72
Chhattisgarh,"18 - Counterfeiting (Section 231-235,237-240, 242-243, 255 and 489-A to 489-E IPC)",8,29,1,0,38
Chhattisgarh,"18.1 - Offences related to Counterfeit Coin (Section 231-235,237, 238-240 & 242-243 IPC)",0,0,0,0,0
Chhattisgarh,18.2 - Counterfeiting Government Stamp (Section 255 IPC),0,0,0,0,0
Chhattisgarh,18.3 - Counterfeit currency & Bank notes (Section 489-A to 489-E IPC),8,29,1,0,38
Chhattisgarh,18.3.1 - Counterfeiting currency notes or Bank notes (Section 489A IPC),6,19,1,0,26
Chhattisgarh,18.3.2 - Using forged or counterfeit currency/Bank notes (Section 489B IPC),2,10,0,0,12
Chhattisgarh,18.3.3 - Possession of forged or counterfeiting currency / Bank notes (Section 489C IPC),0,0,0,0,0
Chhattisgarh,18.3.4 - Make/Possess materials for forging or counterfeiting currency/Bank notes (Section 489D IPC),0,0,0,0,0
Chhattisgarh,18.3.5 - Make/Use documents resembling currency notes/Bank notes (Section 489 E IPC),0,0,0,0,0
Chhattisgarh,19 - Arson (Section 435-436 & 438 IPC),137,134,21,3,295
Chhattisgarh,"20 - Grievous Hurt (Section 325,326,326A & 326 B IPC)",2884,2011,705,42,5642
Chhattisgarh,20.1 - Grievous Hurt (Section 325 & 326 IPC),2881,2011,705,42,5639
Chhattisgarh,20.2 - Acid attack (Section 326A IPC),3,0,0,0,3
Chhattisgarh,20.3 - Attempt to Acid Attack (Section 326B IPC),0,0,0,0,0
Chhattisgarh,21 - Dowry Deaths (Section 304-B IPC),142,111,67,17,337
Chhattisgarh,22 - Assault on women with intent to outrage her Modesty (Section 354 IPC),1697,929,328,16,2970
Chhattisgarh,22.1 - Sexual Harassment (Section 354A IPC),443,180,42,4,669
Chhattisgarh,22.2 - Assault on women with intent to Disrobe (Section 354B IPC),61,23,2,0,86
Chhattisgarh,22.3 - Voyeurism (Section 354C IPC),13,0,0,0,13
Chhattisgarh,22.4 - Stalking (Section 354D IPC),142,46,4,0,192
Chhattisgarh,22.5 - Others,1038,680,280,12,2010
Chhattisgarh,23 - Insult to the Modesty of Women (Section 509 IPC),64,24,3,0,91
Chhattisgarh,23.1 - At Office premises,0,0,0,0,0
Chhattisgarh,23.2 - Places related to work other than Office,12,1,0,0,13
Chhattisgarh,23.3 - In Public Transport system,0,0,0,0,0
Chhattisgarh,23.4 - in Other Places,52,23,3,0,78
Chhattisgarh,24 - Cruelty by Husband or his Relatives (Section 498-A IPC),957,886,558,129,2530
Chhattisgarh,25 - Importation of Girls from Foreign Country (Section 366-B IPC),0,0,0,0,0
Chhattisgarh,26 - Causing Death by Negligence (Section 304-A IPC),1182,1092,382,12,2668
Chhattisgarh,26.1 - Deaths due to negligent driving/act,1068,948,277,11,2304
Chhattisgarh,26.2 - Deaths due to Other Causes,114,144,105,1,364
Chhattisgarh,"27 - Offences against State (Section 121, 121A, 122, 123, 124-A IPC)",3,4,0,0,7
Chhattisgarh,27.1 - Sedition (Section 124A IPC),0,1,0,0,1
Chhattisgarh,27.2 - Other offences against State,3,3,0,0,6
Chhattisgarh,28 - Offences promoting enmity between different groups (Section 153A & 153B IPC),2,0,0,0,2
Chhattisgarh,28.1 - Promoting enmity on ground of religion race and place of Birth (Section 153A IPC),2,0,0,0,2
Chhattisgarh,28.2 - Imputation & assertions prejudicial to national integration (Section 153B IPC),0,0,0,0,0
Chhattisgarh,29 - Extortion (Section 384 - 389 IPC),62,25,5,0,92
Chhattisgarh,30 - Disclosure of Identity of Victims (Section 228 A IPC),0,0,0,0,0
Chhattisgarh,31 - Incidence of Rash Driving (Section 279 IPC Read with 337 & 338),3505,2619,901,65,7090
Chhattisgarh,32 - Human Trafficking (Section 370 & 370A IPC),39,30,4,3,76
Chhattisgarh,33 - Unnatural Offences U/s 377 IPC,11,6,0,0,17
Chhattisgarh,34 - Other IPC crimes,14140,13105,5780,411,33436
Chhattisgarh,35 - Total Cognizable IPC crimes,34619,26964,10941,930,73454
Goa,1 - Murder (Section 302 IPC),23,18,3,1,45
Goa,2 - Attempt to commit Murder (Section 307 IPC),55,25,3,1,84
Goa,3 - Culpable Homicide not amounting to Murder (Section 304 IPC),5,10,7,5,27
Goa,4 - Attempt to commit Culpable Homicide (Section 308 IPC),0,0,0,0,0
Goa,5 - Rape (Section 376 IPC),52,36,6,5,99
Goa,5.1 - Custodial Rape,0,0,0,0,0
Goa,5.1.1 - Gang Rape,0,0,0,0,0
Goa,5.1.2 - Other Rape,0,0,0,0,0
Goa,5.2 - Rape other than Custodial,52,36,6,5,99
Goa,5.2.1 - Gang Rape,2,0,0,0,2
Goa,5.2.2 - Other Rape,50,36,6,5,97
Goa,6 - Attempt to commit Rape (Section 376/511 IPC),2,0,0,0,2
Goa,"7 - Kidnapping & Abduction_Total (Section 3,364,364A, 366-369 IPC)",39,14,1,0,54
Goa,7.1 - Kidnapping & Abduction (Section 363 IPC),32,11,1,0,44
Goa,7.2 - Kidnaping & Abduction in order to Murder (Section 364 IPC),0,0,0,0,0
Goa,7.3 - Kidnapping for Ransom (Section 364A IPC),2,1,0,0,3
Goa,7.4 - Kidnapping & Abduction of Women to compel her for marriage (Section 366 IPC),0,0,0,0,0
Goa,7.5 - Other Kidnapping,5,2,0,0,7
Goa,"8 - Dacoity (Section 395,396-398 IPC)",27,4,1,0,32
Goa,8.1 - Dacoity with Murder (Section 396 IPC),0,0,0,0,0
Goa,8.2 - Other Dacoity,27,4,1,0,32
Goa,9 - Making Preparation and Assembly for committing Dacoity (Section 399 & 402 IPC),0,0,0,0,0
Goa,"10 - Robbery (Section 392 to 394, 397 and 398 IPC)",23,17,2,0,42
Goa,11 - Criminal Trespass/Burglary_Total (Section 453 to 460 IPC),157,59,16,1,233
Goa,"11.1 - Criminal Trespass/Burglary (Section 455, 457 & 458 IPC)",124,44,13,0,181
Goa,"11.2 - House Trespass & House Breaking (Section 453,454,456,459 & 460 IPC)",33,15,3,1,52
Goa,12 - Theft (Section 379 to 382 IPC),372,184,33,10,599
Goa,12.1 - Auto Theft,90,31,2,1,124
Goa,12.2 - Other Thefts,282,153,31,9,475
Goa,"13 - Unlawful Assembly (Section 143,144 & 145)",22,27,14,4,67
Goa,"14 - Riots (Section 147, 148, 149, 150 & 151 IPC)",199,229,75,15,518
Goa,14.1 - Communal,0,0,0,0,0
Goa,14.2 - Industrial,0,0,0,0,0
Goa,14.3 - Political,0,0,0,0,0
Goa,14.4 - Caste Conflict,0,0,0,0,0
Goa,14.4.1 - SC/STs Vs. Non-SCs/STs,0,0,0,0,0
Goa,14.4.2 - Other Caste Riots,0,0,0,0,0
Goa,14.5 - Agrarian,0,0,0,0,0
Goa,14.6 - Students,0,0,0,0,0
Goa,14.7 - Sectarian,0,0,0,0,0
Goa,14.8 - Other Riots,199,229,75,15,518
Goa,15 - Criminal Breach of Trust (Section 406 to 409 IPC),23,18,4,1,46
Goa,16 - Cheating (Section 420 IPC),43,73,28,8,152
Goa,"17 - Forgery (Section 465, 468 & 471 IPC)",0,3,0,0,3
Goa,"18 - Counterfeiting (Section 231-235,237-240, 242-243, 255 and 489-A to 489-E IPC)",5,0,0,0,5
Goa,"18.1 - Offences related to Counterfeit Coin (Section 231-235,237, 238-240 & 242-243 IPC)",0,0,0,0,0
Goa,18.2 - Counterfeiting Government Stamp (Section 255 IPC),0,0,0,0,0
Goa,18.3 - Counterfeit currency & Bank notes (Section 489-A to 489-E IPC),5,0,0,0,5
Goa,18.3.1 - Counterfeiting currency notes or Bank notes (Section 489A IPC),5,0,0,0,5
Goa,18.3.2 - Using forged or counterfeit currency/Bank notes (Section 489B IPC),0,0,0,0,0
Goa,18.3.3 - Possession of forged or counterfeiting currency / Bank notes (Section 489C IPC),0,0,0,0,0
Goa,18.3.4 - Make/Possess materials for forging or counterfeiting currency/Bank notes (Section 489D IPC),0,0,0,0,0
Goa,18.3.5 - Make/Use documents resembling currency notes/Bank notes (Section 489 E IPC),0,0,0,0,0
Goa,19 - Arson (Section 435-436 & 438 IPC),18,13,3,1,35
Goa,"20 - Grievous Hurt (Section 325,326,326A & 326 B IPC)",66,66,26,5,163
Goa,20.1 - Grievous Hurt (Section 325 & 326 IPC),66,66,26,5,163
Goa,20.2 - Acid attack (Section 326A IPC),0,0,0,0,0
Goa,20.3 - Attempt to Acid Attack (Section 326B IPC),0,0,0,0,0
Goa,21 - Dowry Deaths (Section 304-B IPC),0,0,0,0,0
Goa,22 - Assault on women with intent to outrage her Modesty (Section 354 IPC),95,50,35,7,187
Goa,22.1 - Sexual Harassment (Section 354A IPC),17,19,18,2,56
Goa,22.2 - Assault on women with intent to Disrobe (Section 354B IPC),1,3,0,0,4
Goa,22.3 - Voyeurism (Section 354C IPC),3,2,0,2,7
Goa,22.4 - Stalking (Section 354D IPC),11,7,1,0,19
Goa,22.5 - Others,63,19,16,3,101
Goa,23 - Insult to the Modesty of Women (Section 509 IPC),22,13,11,1,47
Goa,23.1 - At Office premises,0,1,0,0,1
Goa,23.2 - Places related to work other than Office,0,0,0,0,0
Goa,23.3 - In Public Transport system,0,0,0,0,0
Goa,23.4 - in Other Places,22,12,11,1,46
Goa,24 - Cruelty by Husband or his Relatives (Section 498-A IPC),11,16,6,5,38
Goa,25 - Importation of Girls from Foreign Country (Section 366-B IPC),0,0,0,0,0
Goa,26 - Causing Death by Negligence (Section 304-A IPC),69,65,29,1,164
Goa,26.1 - Deaths due to negligent driving/act,67,62,29,1,159
Goa,26.2 - Deaths due to Other Causes,2,3,0,0,5
Goa,"27 - Offences against State (Section 121, 121A, 122, 123, 124-A IPC)",0,0,0,0,0
Goa,27.1 - Sedition (Section 124A IPC),0,0,0,0,0
Goa,27.2 - Other offences against State,0,0,0,0,0
Goa,28 - Offences promoting enmity between different groups (Section 153A & 153B IPC),0,0,0,0,0
Goa,28.1 - Promoting enmity on ground of religion race and place of Birth (Section 153A IPC),0,0,0,0,0
Goa,28.2 - Imputation & assertions prejudicial to national integration (Section 153B IPC),0,0,0,0,0
Goa,29 - Extortion (Section 384 - 389 IPC),11,12,0,0,23
Goa,30 - Disclosure of Identity of Victims (Section 228 A IPC),0,0,0,0,0
Goa,31 - Incidence of Rash Driving (Section 279 IPC Read with 337 & 338),244,200,58,8,510
Goa,32 - Human Trafficking (Section 370 & 370A IPC),37,16,6,1,60
Goa,33 - Unnatural Offences U/s 377 IPC,0,0,0,0,0
Goa,34 - Other IPC crimes,311,273,110,18,712
Goa,35 - Total Cognizable IPC crimes,1931,1441,477,98,3947
Gujarat,1 - Murder (Section 302 IPC),1023,1009,339,37,2408
Gujarat,2 - Attempt to commit Murder (Section 307 IPC),1256,1270,410,24,2960
Gujarat,3 - Culpable Homicide not amounting to Murder (Section 304 IPC),31,48,21,3,103
Gujarat,4 - Attempt to commit Culpable Homicide (Section 308 IPC),12,1,0,0,13
Gujarat,5 - Rape (Section 376 IPC),701,374,85,5,1165
Gujarat,5.1 - Custodial Rape,0,0,0,0,0
Gujarat,5.1.1 - Gang Rape,0,0,0,0,0
Gujarat,5.1.2 - Other Rape,0,0,0,0,0
Gujarat,5.2 - Rape other than Custodial,701,374,85,5,1165
Gujarat,5.2.1 - Gang Rape,48,16,0,0,64
Gujarat,5.2.2 - Other Rape,653,358,85,5,1101
Gujarat,6 - Attempt to commit Rape (Section 376/511 IPC),5,0,1,1,7
Gujarat,"7 - Kidnapping & Abduction_Total (Section 3,364,364A, 366-369 IPC)",1893,847,177,10,2927
Gujarat,7.1 - Kidnapping & Abduction (Section 363 IPC),465,192,54,2,713
Gujarat,7.2 - Kidnaping & Abduction in order to Murder (Section 364 IPC),0,0,0,0,0
Gujarat,7.3 - Kidnapping for Ransom (Section 364A IPC),56,45,5,0,106
Gujarat,7.4 - Kidnapping & Abduction of Women to compel her for marriage (Section 366 IPC),1050,380,65,6,1501
Gujarat,7.5 - Other Kidnapping,322,230,53,2,607
Gujarat,"8 - Dacoity (Section 395,396-398 IPC)",676,596,119,5,1396
Gujarat,8.1 - Dacoity with Murder (Section 396 IPC),0,0,0,0,0
Gujarat,8.2 - Other Dacoity,676,596,119,5,1396
Gujarat,9 - Making Preparation and Assembly for committing Dacoity (Section 399 & 402 IPC),33,35,9,0,77
Gujarat,"10 - Robbery (Section 392 to 394, 397 and 398 IPC)",1067,615,95,2,1779
Gujarat,11 - Criminal Trespass/Burglary_Total (Section 453 to 460 IPC),1785,1053,259,6,3103
Gujarat,"11.1 - Criminal Trespass/Burglary (Section 455, 457 & 458 IPC)",756,395,81,3,1235
Gujarat,"11.2 - House Trespass & House Breaking (Section 453,454,456,459 & 460 IPC)",1029,658,178,3,1868
Gujarat,12 - Theft (Section 379 to 382 IPC),5661,3346,810,21,9838
Gujarat,12.1 - Auto Theft,2213,1148,218,0,3579
Gujarat,12.2 - Other Thefts,3448,2198,592,21,6259
Gujarat,"13 - Unlawful Assembly (Section 143,144 & 145)",727,662,194,10,1593
Gujarat,"14 - Riots (Section 147, 148, 149, 150 & 151 IPC)",4219,3988,1465,126,9798
Gujarat,14.1 - Communal,439,275,69,0,783
Gujarat,14.2 - Industrial,10,3,2,0,15
Gujarat,14.3 - Political,31,41,37,6,115
Gujarat,14.4 - Caste Conflict,362,323,105,7,797
Gujarat,14.4.1 - SC/STs Vs. Non-SCs/STs,116,101,31,2,250
Gujarat,14.4.2 - Other Caste Riots,246,222,74,5,547
Gujarat,14.5 - Agrarian,180,178,69,8,435
Gujarat,14.6 - Students,1,0,0,0,1
Gujarat,14.7 - Sectarian,2,13,4,0,19
Gujarat,14.8 - Other Riots,3194,3155,1179,105,7633
Gujarat,15 - Criminal Breach of Trust (Section 406 to 409 IPC),507,937,347,46,1837
Gujarat,16 - Cheating (Section 420 IPC),619,1075,514,53,2261
Gujarat,"17 - Forgery (Section 465, 468 & 471 IPC)",136,226,83,5,450
Gujarat,"18 - Counterfeiting (Section 231-235,237-240, 242-243, 255 and 489-A to 489-E IPC)",15,46,0,0,61
Gujarat,"18.1 - Offences related to Counterfeit Coin (Section 231-235,237, 238-240 & 242-243 IPC)",1,0,0,0,1
Gujarat,18.2 - Counterfeiting Government Stamp (Section 255 IPC),0,0,0,0,0
Gujarat,18.3 - Counterfeit currency & Bank notes (Section 489-A to 489-E IPC),14,46,0,0,60
Gujarat,18.3.1 - Counterfeiting currency notes or Bank notes (Section 489A IPC),11,31,0,0,42
Gujarat,18.3.2 - Using forged or counterfeit currency/Bank notes (Section 489B IPC),1,2,0,0,3
Gujarat,18.3.3 - Possession of forged or counterfeiting currency / Bank notes (Section 489C IPC),2,12,0,0,14
Gujarat,18.3.4 - Make/Possess materials for forging or counterfeiting currency/Bank notes (Section 489D IPC),0,0,0,0,0
Gujarat,18.3.5 - Make/Use documents resembling currency notes/Bank notes (Section 489 E IPC),0,1,0,0,1
Gujarat,19 - Arson (Section 435-436 & 438 IPC),162,175,60,4,401
Gujarat,"20 - Grievous Hurt (Section 325,326,326A & 326 B IPC)",3054,2922,1112,58,7146
Gujarat,20.1 - Grievous Hurt (Section 325 & 326 IPC),3051,2916,1109,58,7134
Gujarat,20.2 - Acid attack (Section 326A IPC),1,5,3,0,9
Gujarat,20.3 - Attempt to Acid Attack (Section 326B IPC),2,1,0,0,3
Gujarat,21 - Dowry Deaths (Section 304-B IPC),16,22,20,1,59
Gujarat,22 - Assault on women with intent to outrage her Modesty (Section 354 IPC),1103,696,164,15,1978
Gujarat,22.1 - Sexual Harassment (Section 354A IPC),355,159,42,4,560
Gujarat,22.2 - Assault on women with intent to Disrobe (Section 354B IPC),40,29,6,0,75
Gujarat,22.3 - Voyeurism (Section 354C IPC),7,2,1,0,10
Gujarat,22.4 - Stalking (Section 354D IPC),48,27,7,0,82
Gujarat,22.5 - Others,653,479,108,11,1251
Gujarat,23 - Insult to the Modesty of Women (Section 509 IPC),132,47,10,2,191
Gujarat,23.1 - At Office premises,1,0,0,0,1
Gujarat,23.2 - Places related to work other than Office,1,2,0,0,3
Gujarat,23.3 - In Public Transport system,0,0,0,0,0
Gujarat,23.4 - in Other Places,130,45,10,2,187
Gujarat,24 - Cruelty by Husband or his Relatives (Section 498-A IPC),6429,7665,4312,762,19168
Gujarat,25 - Importation of Girls from Foreign Country (Section 366-B IPC),0,0,0,0,0
Gujarat,26 - Causing Death by Negligence (Section 304-A IPC),1965,2547,865,41,5418
Gujarat,26.1 - Deaths due to negligent driving/act,1937,2507,855,40,5339
Gujarat,26.2 - Deaths due to Other Causes,28,40,10,1,79
Gujarat,"27 - Offences against State (Section 121, 121A, 122, 123, 124-A IPC)",0,0,0,0,0
Gujarat,27.1 - Sedition (Section 124A IPC),0,0,0,0,0
Gujarat,27.2 - Other offences against State,0,0,0,0,0
Gujarat,28 - Offences promoting enmity between different groups (Section 153A & 153B IPC),15,3,3,0,21
Gujarat,28.1 - Promoting enmity on ground of religion race and place of Birth (Section 153A IPC),15,3,2,0,20
Gujarat,28.2 - Imputation & assertions prejudicial to national integration (Section 153B IPC),0,0,1,0,1
Gujarat,29 - Extortion (Section 384 - 389 IPC),171,160,37,3,371
Gujarat,30 - Disclosure of Identity of Victims (Section 228 A IPC),0,0,0,0,0
Gujarat,31 - Incidence of Rash Driving (Section 279 IPC Read with 337 & 338),13408,11215,4080,125,28828
Gujarat,32 - Human Trafficking (Section 370 & 370A IPC),1,10,0,0,11
Gujarat,33 - Unnatural Offences U/s 377 IPC,12,3,4,1,20
Gujarat,34 - Other IPC crimes,28760,30171,13776,1011,73718
Gujarat,35 - Total Cognizable IPC crimes,75594,71764,29371,2377,179106
Haryana,1 - Murder (Section 302 IPC),909,699,283,7,1898
Haryana,2 - Attempt to commit Murder (Section 307 IPC),778,486,246,10,1520
Haryana,3 - Culpable Homicide not amounting to Murder (Section 304 IPC),39,39,6,0,84
Haryana,4 - Attempt to commit Culpable Homicide (Section 308 IPC),6,2,0,0,8
Haryana,5 - Rape (Section 376 IPC),967,343,72,3,1385
Haryana,5.1 - Custodial Rape,0,0,0,0,0
Haryana,5.1.1 - Gang Rape,0,0,0,0,0
Haryana,5.1.2 - Other Rape,0,0,0,0,0
Haryana,5.2 - Rape other than Custodial,967,343,72,3,1385
Haryana,5.2.1 - Gang Rape,340,91,12,1,444
Haryana,5.2.2 - Other Rape,627,252,60,2,941
Haryana,6 - Attempt to commit Rape (Section 376/511 IPC),104,26,3,0,133
Haryana,"7 - Kidnapping & Abduction_Total (Section 3,364,364A, 366-369 IPC)",968,373,53,0,1394
Haryana,7.1 - Kidnapping & Abduction (Section 363 IPC),49,11,0,0,60
Haryana,7.2 - Kidnaping & Abduction in order to Murder (Section 364 IPC),26,12,1,0,39
Haryana,7.3 - Kidnapping for Ransom (Section 364A IPC),8,4,0,0,12
Haryana,7.4 - Kidnapping & Abduction of Women to compel her for marriage (Section 366 IPC),376,127,8,0,511
Haryana,7.5 - Other Kidnapping,509,219,44,0,772
Haryana,"8 - Dacoity (Section 395,396-398 IPC)",351,139,8,0,498
Haryana,8.1 - Dacoity with Murder (Section 396 IPC),5,1,0,0,6
Haryana,8.2 - Other Dacoity,346,138,8,0,492
Haryana,9 - Making Preparation and Assembly for committing Dacoity (Section 399 & 402 IPC),288,89,9,0,386
Haryana,"10 - Robbery (Section 392 to 394, 397 and 398 IPC)",916,379,65,0,1360
Haryana,11 - Criminal Trespass/Burglary_Total (Section 453 to 460 IPC),2017,961,214,1,3193
Haryana,"11.1 - Criminal Trespass/Burglary (Section 455, 457 & 458 IPC)",1705,825,185,1,2716
Haryana,"11.2 - House Trespass & House Breaking (Section 453,454,456,459 & 460 IPC)",312,136,29,0,477
Haryana,12 - Theft (Section 379 to 382 IPC),4101,2087,447,5,6640
Haryana,12.1 - Auto Theft,2281,1095,175,1,3552
Haryana,12.2 - Other Thefts,1820,992,272,4,3088
Haryana,"13 - Unlawful Assembly (Section 143,144 & 145)",0,0,0,0,0
Haryana,"14 - Riots (Section 147, 148, 149, 150 & 151 IPC)",3410,2424,793,71,6698
Haryana,14.1 - Communal,478,211,36,14,739
Haryana,14.2 - Industrial,0,0,0,0,0
Haryana,14.3 - Political,0,0,0,0,0
Haryana,14.4 - Caste Conflict,72,115,11,4,202
Haryana,14.4.1 - SC/STs Vs. Non-SCs/STs,0,0,0,0,0
Haryana,14.4.2 - Other Caste Riots,72,115,11,4,202
Haryana,14.5 - Agrarian,0,0,0,0,0
Haryana,14.6 - Students,0,0,0,0,0
Haryana,14.7 - Sectarian,0,0,0,0,0
Haryana,14.8 - Other Riots,2860,2098,746,53,5757
Haryana,15 - Criminal Breach of Trust (Section 406 to 409 IPC),238,233,74,10,555
Haryana,16 - Cheating (Section 420 IPC),544,545,261,37,1387
Haryana,"17 - Forgery (Section 465, 468 & 471 IPC)",124,296,154,9,583
Haryana,"18 - Counterfeiting (Section 231-235,237-240, 242-243, 255 and 489-A to 489-E IPC)",26,12,5,0,43
Haryana,"18.1 - Offences related to Counterfeit Coin (Section 231-235,237, 238-240 & 242-243 IPC)",0,0,0,0,0
Haryana,18.2 - Counterfeiting Government Stamp (Section 255 IPC),0,0,0,0,0
Haryana,18.3 - Counterfeit currency & Bank notes (Section 489-A to 489-E IPC),26,12,5,0,43
Haryana,18.3.1 - Counterfeiting currency notes or Bank notes (Section 489A IPC),8,8,3,0,19
Haryana,18.3.2 - Using forged or counterfeit currency/Bank notes (Section 489B IPC),11,4,2,0,17
Haryana,18.3.3 - Possession of forged or counterfeiting currency / Bank notes (Section 489C IPC),7,0,0,0,7
Haryana,18.3.4 - Make/Possess materials for forging or counterfeiting currency/Bank notes (Section 489D IPC),0,0,0,0,0
Haryana,18.3.5 - Make/Use documents resembling currency notes/Bank notes (Section 489 E IPC),0,0,0,0,0
Haryana,19 - Arson (Section 435-436 & 438 IPC),77,85,18,3,183
Haryana,"20 - Grievous Hurt (Section 325,326,326A & 326 B IPC)",1455,1172,565,36,3228
Haryana,20.1 - Grievous Hurt (Section 325 & 326 IPC),1443,1168,565,36,3212
Haryana,20.2 - Acid attack (Section 326A IPC),10,2,0,0,12
Haryana,20.3 - Attempt to Acid Attack (Section 326B IPC),2,2,0,0,4
Haryana,21 - Dowry Deaths (Section 304-B IPC),289,140,115,24,568
Haryana,22 - Assault on women with intent to outrage her Modesty (Section 354 IPC),1343,572,87,7,2009
Haryana,22.1 - Sexual Harassment (Section 354A IPC),470,181,22,7,680
Haryana,22.2 - Assault on women with intent to Disrobe (Section 354B IPC),182,59,4,0,245
Haryana,22.3 - Voyeurism (Section 354C IPC),23,3,0,0,26
Haryana,22.4 - Stalking (Section 354D IPC),206,80,2,0,288
Haryana,22.5 - Others,462,249,59,0,770
Haryana,23 - Insult to the Modesty of Women (Section 509 IPC),70,21,3,0,94
Haryana,23.1 - At Office premises,0,0,0,0,0
Haryana,23.2 - Places related to work other than Office,1,0,0,0,1
Haryana,23.3 - In Public Transport system,1,0,0,0,1
Haryana,23.4 - in Other Places,68,21,3,0,92
Haryana,24 - Cruelty by Husband or his Relatives (Section 498-A IPC),1797,1341,886,180,4204
Haryana,25 - Importation of Girls from Foreign Country (Section 366-B IPC),0,0,0,0,0
Haryana,26 - Causing Death by Negligence (Section 304-A IPC),1564,1371,488,27,3450
Haryana,26.1 - Deaths due to negligent driving/act,1499,1306,475,25,3305
Haryana,26.2 - Deaths due to Other Causes,65,65,13,2,145
Haryana,"27 - Offences against State (Section 121, 121A, 122, 123, 124-A IPC)",0,0,0,0,0
Haryana,27.1 - Sedition (Section 124A IPC),0,0,0,0,0
Haryana,27.2 - Other offences against State,0,0,0,0,0
Haryana,28 - Offences promoting enmity between different groups (Section 153A & 153B IPC),0,0,0,0,0
Haryana,28.1 - Promoting enmity on ground of religion race and place of Birth (Section 153A IPC),0,0,0,0,0
Haryana,28.2 - Imputation & assertions prejudicial to national integration (Section 153B IPC),0,0,0,0,0
Haryana,29 - Extortion (Section 384 - 389 IPC),136,116,15,0,267
Haryana,30 - Disclosure of Identity of Victims (Section 228 A IPC),0,0,0,0,0
Haryana,31 - Incidence of Rash Driving (Section 279 IPC Read with 337 & 338),2513,1944,603,46,5106
Haryana,32 - Human Trafficking (Section 370 & 370A IPC),10,5,3,1,19
Haryana,33 - Unnatural Offences U/s 377 IPC,78,30,6,0,114
Haryana,34 - Other IPC crimes,14985,10282,3540,431,29238
Haryana,35 - Total Cognizable IPC crimes,40103,26212,9022,908,76245
Himachal Pradesh,1 - Murder (Section 302 IPC),88,67,41,3,199
Himachal Pradesh,2 - Attempt to commit Murder (Section 307 IPC),43,50,23,8,124
Himachal Pradesh,3 - Culpable Homicide not amounting to Murder (Section 304 IPC),5,5,3,0,13
Himachal Pradesh,4 - Attempt to commit Culpable Homicide (Section 308 IPC),0,0,0,0,0
Himachal Pradesh,5 - Rape (Section 376 IPC),189,95,29,4,317
Himachal Pradesh,5.1 - Custodial Rape,0,0,0,0,0
Himachal Pradesh,5.1.1 - Gang Rape,0,0,0,0,0
Himachal Pradesh,5.1.2 - Other Rape,0,0,0,0,0
Himachal Pradesh,5.2 - Rape other than Custodial,189,95,29,4,317
Himachal Pradesh,5.2.1 - Gang Rape,16,3,0,0,19
Himachal Pradesh,5.2.2 - Other Rape,173,92,29,4,298
Himachal Pradesh,6 - Attempt to commit Rape (Section 376/511 IPC),3,1,0,0,4
Himachal Pradesh,"7 - Kidnapping & Abduction_Total (Section 3,364,364A, 366-369 IPC)",77,27,6,0,110
Himachal Pradesh,7.1 - Kidnapping & Abduction (Section 363 IPC),10,4,1,0,15
Himachal Pradesh,7.2 - Kidnaping & Abduction in order to Murder (Section 364 IPC),0,0,0,0,0
Himachal Pradesh,7.3 - Kidnapping for Ransom (Section 364A IPC),0,0,2,0,2
Himachal Pradesh,7.4 - Kidnapping & Abduction of Women to compel her for marriage (Section 366 IPC),44,19,1,0,64
Himachal Pradesh,7.5 - Other Kidnapping,23,4,2,0,29
Himachal Pradesh,"8 - Dacoity (Section 395,396-398 IPC)",8,4,0,0,12
Himachal Pradesh,8.1 - Dacoity with Murder (Section 396 IPC),0,0,0,0,0
Himachal Pradesh,8.2 - Other Dacoity,8,4,0,0,12
Himachal Pradesh,9 - Making Preparation and Assembly for committing Dacoity (Section 399 & 402 IPC),0,0,0,0,0
Himachal Pradesh,"10 - Robbery (Section 392 to 394, 397 and 398 IPC)",15,10,0,0,25
Himachal Pradesh,11 - Criminal Trespass/Burglary_Total (Section 453 to 460 IPC),321,234,86,11,652
Himachal Pradesh,"11.1 - Criminal Trespass/Burglary (Section 455, 457 & 458 IPC)",105,90,37,0,232
Himachal Pradesh,"11.2 - House Trespass & House Breaking (Section 453,454,456,459 & 460 IPC)",216,144,49,11,420
Himachal Pradesh,12 - Theft (Section 379 to 382 IPC),315,187,81,3,586
Himachal Pradesh,12.1 - Auto Theft,64,44,9,0,117
Himachal Pradesh,12.2 - Other Thefts,251,143,72,3,469
Himachal Pradesh,"13 - Unlawful Assembly (Section 143,144 & 145)",51,23,7,3,84
Himachal Pradesh,"14 - Riots (Section 147, 148, 149, 150 & 151 IPC)",925,910,543,109,2487
Himachal Pradesh,14.1 - Communal,0,0,0,0,0
Himachal Pradesh,14.2 - Industrial,0,0,0,0,0
Himachal Pradesh,14.3 - Political,7,15,5,2,29
Himachal Pradesh,14.4 - Caste Conflict,0,0,0,0,0
Himachal Pradesh,14.4.1 - SC/STs Vs. Non-SCs/STs,0,0,0,0,0
Himachal Pradesh,14.4.2 - Other Caste Riots,0,0,0,0,0
Himachal Pradesh,14.5 - Agrarian,0,0,0,0,0
Himachal Pradesh,14.6 - Students,68,40,22,4,134
Himachal Pradesh,14.7 - Sectarian,0,0,0,0,0
Himachal Pradesh,14.8 - Other Riots,850,855,516,103,2324
Himachal Pradesh,15 - Criminal Breach of Trust (Section 406 to 409 IPC),28,43,24,1,96
Himachal Pradesh,16 - Cheating (Section 420 IPC),93,191,116,12,412
Himachal Pradesh,"17 - Forgery (Section 465, 468 & 471 IPC)",10,25,6,2,43
Himachal Pradesh,"18 - Counterfeiting (Section 231-235,237-240, 242-243, 255 and 489-A to 489-E IPC)",3,0,0,0,3
Himachal Pradesh,"18.1 - Offences related to Counterfeit Coin (Section 231-235,237, 238-240 & 242-243 IPC)",0,0,0,0,0
Himachal Pradesh,18.2 - Counterfeiting Government Stamp (Section 255 IPC),0,0,0,0,0
Himachal Pradesh,18.3 - Counterfeit currency & Bank notes (Section 489-A to 489-E IPC),3,0,0,0,3
Himachal Pradesh,18.3.1 - Counterfeiting currency notes or Bank notes (Section 489A IPC),0,0,0,0,0
Himachal Pradesh,18.3.2 - Using forged or counterfeit currency/Bank notes (Section 489B IPC),0,0,0,0,0
Himachal Pradesh,18.3.3 - Possession of forged or counterfeiting currency / Bank notes (Section 489C IPC),3,0,0,0,3
Himachal Pradesh,18.3.4 - Make/Possess materials for forging or counterfeiting currency/Bank notes (Section 489D IPC),0,0,0,0,0
Himachal Pradesh,18.3.5 - Make/Use documents resembling currency notes/Bank notes (Section 489 E IPC),0,0,0,0,0
Himachal Pradesh,19 - Arson (Section 435-436 & 438 IPC),26,32,23,5,86
Himachal Pradesh,"20 - Grievous Hurt (Section 325,326,326A & 326 B IPC)",366,384,201,30,981
Himachal Pradesh,20.1 - Grievous Hurt (Section 325 & 326 IPC),366,383,201,30,980
Himachal Pradesh,20.2 - Acid attack (Section 326A IPC),0,1,0,0,1
Himachal Pradesh,20.3 - Attempt to Acid Attack (Section 326B IPC),0,0,0,0,0
Himachal Pradesh,21 - Dowry Deaths (Section 304-B IPC),3,0,2,0,5
Himachal Pradesh,22 - Assault on women with intent to outrage her Modesty (Section 354 IPC),272,264,104,28,668
Himachal Pradesh,22.1 - Sexual Harassment (Section 354A IPC),79,77,22,6,184
Himachal Pradesh,22.2 - Assault on women with intent to Disrobe (Section 354B IPC),9,11,4,2,26
Himachal Pradesh,22.3 - Voyeurism (Section 354C IPC),1,1,1,0,3
Himachal Pradesh,22.4 - Stalking (Section 354D IPC),43,17,8,1,69
Himachal Pradesh,22.5 - Others,140,158,69,19,386
Himachal Pradesh,23 - Insult to the Modesty of Women (Section 509 IPC),16,28,12,3,59
Himachal Pradesh,23.1 - At Office premises,0,0,0,0,0
Himachal Pradesh,23.2 - Places related to work other than Office,0,0,0,0,0
Himachal Pradesh,23.3 - In Public Transport system,0,0,0,0,0
Himachal Pradesh,23.4 - in Other Places,16,28,12,3,59
Himachal Pradesh,24 - Cruelty by Husband or his Relatives (Section 498-A IPC),190,253,185,51,679
Himachal Pradesh,25 - Importation of Girls from Foreign Country (Section 366-B IPC),0,0,0,0,0
Himachal Pradesh,26 - Causing Death by Negligence (Section 304-A IPC),163,218,98,4,483
Himachal Pradesh,26.1 - Deaths due to negligent driving/act,155,201,76,3,435
Himachal Pradesh,26.2 - Deaths due to Other Causes,8,17,22,1,48
Himachal Pradesh,"27 - Offences against State (Section 121, 121A, 122, 123, 124-A IPC)",0,1,1,0,2
Himachal Pradesh,27.1 - Sedition (Section 124A IPC),0,1,1,0,2
Himachal Pradesh,27.2 - Other offences against State,0,0,0,0,0
Himachal Pradesh,28 - Offences promoting enmity between different groups (Section 153A & 153B IPC),0,0,0,0,0
Himachal Pradesh,28.1 - Promoting enmity on ground of religion race and place of Birth (Section 153A IPC),0,0,0,0,0
Himachal Pradesh,28.2 - Imputation & assertions prejudicial to national integration (Section 153B IPC),0,0,0,0,0
Himachal Pradesh,29 - Extortion (Section 384 - 389 IPC),1,5,0,0,6
Himachal Pradesh,30 - Disclosure of Identity of Victims (Section 228 A IPC),0,0,0,0,0
Himachal Pradesh,31 - Incidence of Rash Driving (Section 279 IPC Read with 337 & 338),906,884,226,17,2033
Himachal Pradesh,32 - Human Trafficking (Section 370 & 370A IPC),0,1,0,0,1
Himachal Pradesh,33 - Unnatural Offences U/s 377 IPC,4,8,1,0,13
Himachal Pradesh,34 - Other IPC crimes,3162,3526,1897,259,8844
Himachal Pradesh,35 - Total Cognizable IPC crimes,7283,7476,3715,553,19027
Jammu & Kashmir,1 - Murder (Section 302 IPC),70,166,38,1,275
Jammu & Kashmir,2 - Attempt to commit Murder (Section 307 IPC),332,554,131,89,1106
Jammu & Kashmir,3 - Culpable Homicide not amounting to Murder (Section 304 IPC),4,15,4,0,23
Jammu & Kashmir,4 - Attempt to commit Culpable Homicide (Section 308 IPC),0,0,0,0,0
Jammu & Kashmir,5 - Rape (Section 376 IPC),160,156,26,0,342
Jammu & Kashmir,5.1 - Custodial Rape,0,0,0,0,0
Jammu & Kashmir,5.1.1 - Gang Rape,0,0,0,0,0
Jammu & Kashmir,5.1.2 - Other Rape,0,0,0,0,0
Jammu & Kashmir,5.2 - Rape other than Custodial,160,156,26,0,342
Jammu & Kashmir,5.2.1 - Gang Rape,0,0,0,0,0
Jammu & Kashmir,5.2.2 - Other Rape,160,156,26,0,342
Jammu & Kashmir,6 - Attempt to commit Rape (Section 376/511 IPC),6,11,0,0,17
Jammu & Kashmir,"7 - Kidnapping & Abduction_Total (Section 3,364,364A, 366-369 IPC)",249,480,40,0,769
Jammu & Kashmir,7.1 - Kidnapping & Abduction (Section 363 IPC),70,174,6,0,250
Jammu & Kashmir,7.2 - Kidnaping & Abduction in order to Murder (Section 364 IPC),5,7,0,0,12
Jammu & Kashmir,7.3 - Kidnapping for Ransom (Section 364A IPC),0,0,0,0,0
Jammu & Kashmir,7.4 - Kidnapping & Abduction of Women to compel her for marriage (Section 366 IPC),75,114,11,0,200
Jammu & Kashmir,7.5 - Other Kidnapping,99,185,23,0,307
Jammu & Kashmir,"8 - Dacoity (Section 395,396-398 IPC)",12,10,4,0,26
Jammu & Kashmir,8.1 - Dacoity with Murder (Section 396 IPC),0,0,0,0,0
Jammu & Kashmir,8.2 - Other Dacoity,12,10,4,0,26
Jammu & Kashmir,9 - Making Preparation and Assembly for committing Dacoity (Section 399 & 402 IPC),0,0,0,0,0
Jammu & Kashmir,"10 - Robbery (Section 392 to 394, 397 and 398 IPC)",18,71,11,0,100
Jammu & Kashmir,11 - Criminal Trespass/Burglary_Total (Section 453 to 460 IPC),281,501,66,0,848
Jammu & Kashmir,"11.1 - Criminal Trespass/Burglary (Section 455, 457 & 458 IPC)",114,177,26,0,317
Jammu & Kashmir,"11.2 - House Trespass & House Breaking (Section 453,454,456,459 & 460 IPC)",167,324,40,0,531
Jammu & Kashmir,12 - Theft (Section 379 to 382 IPC),520,1011,306,27,1864
Jammu & Kashmir,12.1 - Auto Theft,71,169,14,0,254
Jammu & Kashmir,12.2 - Other Thefts,449,842,292,27,1610
Jammu & Kashmir,"13 - Unlawful Assembly (Section 143,144 & 145)",0,0,0,0,0
Jammu & Kashmir,"14 - Riots (Section 147, 148, 149, 150 & 151 IPC)",1304,3382,767,20,5473
Jammu & Kashmir,14.1 - Communal,0,0,0,0,0
Jammu & Kashmir,14.2 - Industrial,0,0,0,0,0
Jammu & Kashmir,14.3 - Political,2,151,0,0,153
Jammu & Kashmir,14.4 - Caste Conflict,0,0,0,0,0
Jammu & Kashmir,14.4.1 - SC/STs Vs. Non-SCs/STs,0,0,0,0,0
Jammu & Kashmir,14.4.2 - Other Caste Riots,0,0,0,0,0
Jammu & Kashmir,14.5 - Agrarian,0,0,0,0,0
Jammu & Kashmir,14.6 - Students,0,0,0,0,0
Jammu & Kashmir,14.7 - Sectarian,0,0,0,0,0
Jammu & Kashmir,14.8 - Other Riots,1302,3231,767,20,5320
Jammu & Kashmir,15 - Criminal Breach of Trust (Section 406 to 409 IPC),33,105,11,0,149
Jammu & Kashmir,16 - Cheating (Section 420 IPC),177,237,138,10,562
Jammu & Kashmir,"17 - Forgery (Section 465, 468 & 471 IPC)",5,9,2,0,16
Jammu & Kashmir,"18 - Counterfeiting (Section 231-235,237-240, 242-243, 255 and 489-A to 489-E IPC)",6,15,5,0,26
Jammu & Kashmir,"18.1 - Offences related to Counterfeit Coin (Section 231-235,237, 238-240 & 242-243 IPC)",0,0,0,0,0
Jammu & Kashmir,18.2 - Counterfeiting Government Stamp (Section 255 IPC),0,0,0,0,0
Jammu & Kashmir,18.3 - Counterfeit currency & Bank notes (Section 489-A to 489-E IPC),6,15,5,0,26
Jammu & Kashmir,18.3.1 - Counterfeiting currency notes or Bank notes (Section 489A IPC),3,7,0,0,10
Jammu & Kashmir,18.3.2 - Using forged or counterfeit currency/Bank notes (Section 489B IPC),3,7,5,0,15
Jammu & Kashmir,18.3.3 - Possession of forged or counterfeiting currency / Bank notes (Section 489C IPC),0,1,0,0,1
Jammu & Kashmir,18.3.4 - Make/Possess materials for forging or counterfeiting currency/Bank notes (Section 489D IPC),0,0,0,0,0
Jammu & Kashmir,18.3.5 - Make/Use documents resembling currency notes/Bank notes (Section 489 E IPC),0,0,0,0,0
Jammu & Kashmir,19 - Arson (Section 435-436 & 438 IPC),40,122,11,0,173
Jammu & Kashmir,"20 - Grievous Hurt (Section 325,326,326A & 326 B IPC)",276,284,133,11,704
Jammu & Kashmir,20.1 - Grievous Hurt (Section 325 & 326 IPC),276,284,133,11,704
Jammu & Kashmir,20.2 - Acid attack (Section 326A IPC),0,0,0,0,0
Jammu & Kashmir,20.3 - Attempt to Acid Attack (Section 326B IPC),0,0,0,0,0
Jammu & Kashmir,21 - Dowry Deaths (Section 304-B IPC),10,4,0,0,14
Jammu & Kashmir,22 - Assault on women with intent to outrage her Modesty (Section 354 IPC),724,1325,522,4,2575
Jammu & Kashmir,22.1 - Sexual Harassment (Section 354A IPC),71,266,18,4,359
Jammu & Kashmir,22.2 - Assault on women with intent to Disrobe (Section 354B IPC),0,254,0,0,254
Jammu & Kashmir,22.3 - Voyeurism (Section 354C IPC),0,0,0,0,0
Jammu & Kashmir,22.4 - Stalking (Section 354D IPC),1,0,0,0,1
Jammu & Kashmir,22.5 - Others,652,805,504,0,1961
Jammu & Kashmir,23 - Insult to the Modesty of Women (Section 509 IPC),154,115,14,0,283
Jammu & Kashmir,23.1 - At Office premises,0,0,0,0,0
Jammu & Kashmir,23.2 - Places related to work other than Office,4,2,1,0,7
Jammu & Kashmir,23.3 - In Public Transport system,0,7,1,0,8
Jammu & Kashmir,23.4 - in Other Places,150,106,12,0,268
Jammu & Kashmir,24 - Cruelty by Husband or his Relatives (Section 498-A IPC),390,477,110,8,985
Jammu & Kashmir,25 - Importation of Girls from Foreign Country (Section 366-B IPC),0,0,0,0,0
Jammu & Kashmir,26 - Causing Death by Negligence (Section 304-A IPC),291,320,93,0,704
Jammu & Kashmir,26.1 - Deaths due to negligent driving/act,286,316,92,0,694
Jammu & Kashmir,26.2 - Deaths due to Other Causes,5,4,1,0,10
Jammu & Kashmir,"27 - Offences against State (Section 121, 121A, 122, 123, 124-A IPC)",0,0,0,0,0
Jammu & Kashmir,27.1 - Sedition (Section 124A IPC),0,0,0,0,0
Jammu & Kashmir,27.2 - Other offences against State,0,0,0,0,0
Jammu & Kashmir,28 - Offences promoting enmity between different groups (Section 153A & 153B IPC),0,0,0,0,0
Jammu & Kashmir,28.1 - Promoting enmity on ground of religion race and place of Birth (Section 153A IPC),0,0,0,0,0
Jammu & Kashmir,28.2 - Imputation & assertions prejudicial to national integration (Section 153B IPC),0,0,0,0,0
Jammu & Kashmir,29 - Extortion (Section 384 - 389 IPC),0,0,0,0,0
Jammu & Kashmir,30 - Disclosure of Identity of Victims (Section 228 A IPC),0,0,0,0,0
Jammu & Kashmir,31 - Incidence of Rash Driving (Section 279 IPC Read with 337 & 338),1729,2243,720,2,4694
Jammu & Kashmir,32 - Human Trafficking (Section 370 & 370A IPC),0,0,0,0,0
Jammu & Kashmir,33 - Unnatural Offences U/s 377 IPC,8,16,0,0,24
Jammu & Kashmir,34 - Other IPC crimes,4421,8014,2162,126,14723
Jammu & Kashmir,35 - Total Cognizable IPC crimes,11220,19643,5314,298,36475
Jharkhand,1 - Murder (Section 302 IPC),953,1481,362,2,2798
Jharkhand,2 - Attempt to commit Murder (Section 307 IPC),414,529,115,2,1060
Jharkhand,3 - Culpable Homicide not amounting to Murder (Section 304 IPC),40,91,22,0,153
Jharkhand,4 - Attempt to commit Culpable Homicide (Section 308 IPC),2,1,0,0,3
Jharkhand,5 - Rape (Section 376 IPC),778,635,144,0,1557
Jharkhand,5.1 - Custodial Rape,0,0,0,0,0
Jharkhand,5.1.1 - Gang Rape,0,0,0,0,0
Jharkhand,5.1.2 - Other Rape,0,0,0,0,0
Jharkhand,5.2 - Rape other than Custodial,778,635,144,0,1557
Jharkhand,5.2.1 - Gang Rape,44,24,5,0,73
Jharkhand,5.2.2 - Other Rape,734,611,139,0,1484
Jharkhand,6 - Attempt to commit Rape (Section 376/511 IPC),129,44,5,0,178
Jharkhand,"7 - Kidnapping & Abduction_Total (Section 3,364,364A, 366-369 IPC)",752,706,86,0,1544
Jharkhand,7.1 - Kidnapping & Abduction (Section 363 IPC),47,83,2,0,132
Jharkhand,7.2 - Kidnaping & Abduction in order to Murder (Section 364 IPC),37,30,6,0,73
Jharkhand,7.3 - Kidnapping for Ransom (Section 364A IPC),17,50,3,0,70
Jharkhand,7.4 - Kidnapping & Abduction of Women to compel her for marriage (Section 366 IPC),468,242,24,0,734
Jharkhand,7.5 - Other Kidnapping,183,301,51,0,535
Jharkhand,"8 - Dacoity (Section 395,396-398 IPC)",206,289,18,0,513
Jharkhand,8.1 - Dacoity with Murder (Section 396 IPC),0,4,0,0,4
Jharkhand,8.2 - Other Dacoity,206,285,18,0,509
Jharkhand,9 - Making Preparation and Assembly for committing Dacoity (Section 399 & 402 IPC),18,10,0,0,28
Jharkhand,"10 - Robbery (Section 392 to 394, 397 and 398 IPC)",473,494,16,0,983
Jharkhand,11 - Criminal Trespass/Burglary_Total (Section 453 to 460 IPC),408,405,64,0,877
Jharkhand,"11.1 - Criminal Trespass/Burglary (Section 455, 457 & 458 IPC)",248,312,27,0,587
Jharkhand,"11.2 - House Trespass & House Breaking (Section 453,454,456,459 & 460 IPC)",160,93,37,0,290
Jharkhand,12 - Theft (Section 379 to 382 IPC),2012,2101,375,0,4488
Jharkhand,12.1 - Auto Theft,663,544,54,0,1261
Jharkhand,12.2 - Other Thefts,1349,1557,321,0,3227
Jharkhand,"13 - Unlawful Assembly (Section 143,144 & 145)",88,68,19,0,175
Jharkhand,"14 - Riots (Section 147, 148, 149, 150 & 151 IPC)",1284,1985,419,0,3688
Jharkhand,14.1 - Communal,94,170,10,0,274
Jharkhand,14.2 - Industrial,0,0,0,0,0
Jharkhand,14.3 - Political,2,22,0,0,24
Jharkhand,14.4 - Caste Conflict,28,54,13,0,95
Jharkhand,14.4.1 - SC/STs Vs. Non-SCs/STs,0,2,0,0,2
Jharkhand,14.4.2 - Other Caste Riots,28,52,13,0,93
Jharkhand,14.5 - Agrarian,3,10,0,0,13
Jharkhand,14.6 - Students,0,0,0,0,0
Jharkhand,14.7 - Sectarian,0,0,0,0,0
Jharkhand,14.8 - Other Riots,1157,1729,396,0,3282
Jharkhand,15 - Criminal Breach of Trust (Section 406 to 409 IPC),301,613,138,0,1052
Jharkhand,16 - Cheating (Section 420 IPC),779,1635,432,0,2846
Jharkhand,"17 - Forgery (Section 465, 468 & 471 IPC)",88,173,39,0,300
Jharkhand,"18 - Counterfeiting (Section 231-235,237-240, 242-243, 255 and 489-A to 489-E IPC)",1,9,2,0,12
Jharkhand,"18.1 - Offences related to Counterfeit Coin (Section 231-235,237, 238-240 & 242-243 IPC)",0,0,0,0,0
Jharkhand,18.2 - Counterfeiting Government Stamp (Section 255 IPC),0,1,0,0,1
Jharkhand,18.3 - Counterfeit currency & Bank notes (Section 489-A to 489-E IPC),1,8,2,0,11
Jharkhand,18.3.1 - Counterfeiting currency notes or Bank notes (Section 489A IPC),1,4,2,0,7
Jharkhand,18.3.2 - Using forged or counterfeit currency/Bank notes (Section 489B IPC),0,0,0,0,0
Jharkhand,18.3.3 - Possession of forged or counterfeiting currency / Bank notes (Section 489C IPC),0,0,0,0,0
Jharkhand,18.3.4 - Make/Possess materials for forging or counterfeiting currency/Bank notes (Section 489D IPC),0,0,0,0,0
Jharkhand,18.3.5 - Make/Use documents resembling currency notes/Bank notes (Section 489 E IPC),0,4,0,0,4
Jharkhand,19 - Arson (Section 435-436 & 438 IPC),85,165,18,0,268
Jharkhand,"20 - Grievous Hurt (Section 325,326,326A & 326 B IPC)",1019,1172,314,73,2578
Jharkhand,20.1 - Grievous Hurt (Section 325 & 326 IPC),1016,1172,314,73,2575
Jharkhand,20.2 - Acid attack (Section 326A IPC),1,0,0,0,1
Jharkhand,20.3 - Attempt to Acid Attack (Section 326B IPC),2,0,0,0,2
Jharkhand,21 - Dowry Deaths (Section 304-B IPC),144,288,63,3,498
Jharkhand,22 - Assault on women with intent to outrage her Modesty (Section 354 IPC),366,217,18,0,601
Jharkhand,22.1 - Sexual Harassment (Section 354A IPC),117,114,3,0,234
Jharkhand,22.2 - Assault on women with intent to Disrobe (Section 354B IPC),50,32,2,0,84
Jharkhand,22.3 - Voyeurism (Section 354C IPC),0,0,0,0,0
Jharkhand,22.4 - Stalking (Section 354D IPC),4,0,0,0,4
Jharkhand,22.5 - Others,195,71,13,0,279
Jharkhand,23 - Insult to the Modesty of Women (Section 509 IPC),46,22,2,0,70
Jharkhand,23.1 - At Office premises,0,0,0,0,0
Jharkhand,23.2 - Places related to work other than Office,0,0,0,0,0
Jharkhand,23.3 - In Public Transport system,0,0,0,0,0
Jharkhand,23.4 - in Other Places,46,22,2,0,70
Jharkhand,24 - Cruelty by Husband or his Relatives (Section 498-A IPC),474,1005,271,5,1755
Jharkhand,25 - Importation of Girls from Foreign Country (Section 366-B IPC),1,1,0,0,2
Jharkhand,26 - Causing Death by Negligence (Section 304-A IPC),766,1545,304,0,2615
Jharkhand,26.1 - Deaths due to negligent driving/act,757,1487,301,0,2545
Jharkhand,26.2 - Deaths due to Other Causes,9,58,3,0,70
Jharkhand,"27 - Offences against State (Section 121, 121A, 122, 123, 124-A IPC)",6,12,0,0,18
Jharkhand,27.1 - Sedition (Section 124A IPC),6,12,0,0,18
Jharkhand,27.2 - Other offences against State,0,0,0,0,0
Jharkhand,28 - Offences promoting enmity between different groups (Section 153A & 153B IPC),0,0,0,0,0
Jharkhand,28.1 - Promoting enmity on ground of religion race and place of Birth (Section 153A IPC),0,0,0,0,0
Jharkhand,28.2 - Imputation & assertions prejudicial to national integration (Section 153B IPC),0,0,0,0,0
Jharkhand,29 - Extortion (Section 384 - 389 IPC),188,251,30,0,469
Jharkhand,30 - Disclosure of Identity of Victims (Section 228 A IPC),0,0,0,0,0
Jharkhand,31 - Incidence of Rash Driving (Section 279 IPC Read with 337 & 338),781,1231,215,6,2233
Jharkhand,32 - Human Trafficking (Section 370 & 370A IPC),49,60,5,0,114
Jharkhand,33 - Unnatural Offences U/s 377 IPC,4,6,0,0,10
Jharkhand,34 - Other IPC crimes,8184,13372,3298,66,24920
Jharkhand,35 - Total Cognizable IPC crimes,20839,30616,6794,157,58406
Karnataka,1 - Murder (Section 302 IPC),1521,1314,503,50,3388
Karnataka,2 - Attempt to commit Murder (Section 307 IPC),2834,2196,1046,112,6188
Karnataka,3 - Culpable Homicide not amounting to Murder (Section 304 IPC),37,78,10,1,126
Karnataka,4 - Attempt to commit Culpable Homicide (Section 308 IPC),85,52,22,1,160
Karnataka,5 - Rape (Section 376 IPC),1229,566,118,10,1923
Karnataka,5.1 - Custodial Rape,0,0,0,0,0
Karnataka,5.1.1 - Gang Rape,0,0,0,0,0
Karnataka,5.1.2 - Other Rape,0,0,0,0,0
Karnataka,5.2 - Rape other than Custodial,1229,566,118,10,1923
Karnataka,5.2.1 - Gang Rape,66,9,0,0,75
Karnataka,5.2.2 - Other Rape,1163,557,118,10,1848
Karnataka,6 - Attempt to commit Rape (Section 376/511 IPC),23,4,0,0,27
Karnataka,"7 - Kidnapping & Abduction_Total (Section 3,364,364A, 366-369 IPC)",1125,699,113,17,1954
Karnataka,7.1 - Kidnapping & Abduction (Section 363 IPC),315,208,16,1,540
Karnataka,7.2 - Kidnaping & Abduction in order to Murder (Section 364 IPC),0,0,0,0,0
Karnataka,7.3 - Kidnapping for Ransom (Section 364A IPC),68,31,2,0,101
Karnataka,7.4 - Kidnapping & Abduction of Women to compel her for marriage (Section 366 IPC),221,137,42,9,409
Karnataka,7.5 - Other Kidnapping,521,323,53,7,904
Karnataka,"8 - Dacoity (Section 395,396-398 IPC)",521,323,29,3,876
Karnataka,8.1 - Dacoity with Murder (Section 396 IPC),0,0,0,0,0
Karnataka,8.2 - Other Dacoity,521,323,29,3,876
Karnataka,9 - Making Preparation and Assembly for committing Dacoity (Section 399 & 402 IPC),1473,430,26,1,1930
Karnataka,"10 - Robbery (Section 392 to 394, 397 and 398 IPC)",2153,819,112,13,3097
Karnataka,11 - Criminal Trespass/Burglary_Total (Section 453 to 460 IPC),3214,2362,649,12,6237
Karnataka,"11.1 - Criminal Trespass/Burglary (Section 455, 457 & 458 IPC)",2174,1761,578,12,4525
Karnataka,"11.2 - House Trespass & House Breaking (Section 453,454,456,459 & 460 IPC)",1040,601,71,0,1712
Karnataka,12 - Theft (Section 379 to 382 IPC),8206,5101,1033,62,14402
Karnataka,12.1 - Auto Theft,3379,2143,413,8,5943
Karnataka,12.2 - Other Thefts,4827,2958,620,54,8459
Karnataka,"13 - Unlawful Assembly (Section 143,144 & 145)",73,98,54,0,225
Karnataka,"14 - Riots (Section 147, 148, 149, 150 & 151 IPC)",9722,10832,4559,549,25662
Karnataka,14.1 - Communal,169,121,47,12,349
Karnataka,14.2 - Industrial,13,43,10,0,66
Karnataka,14.3 - Political,90,110,28,0,228
Karnataka,14.4 - Caste Conflict,122,115,40,0,277
Karnataka,14.4.1 - SC/STs Vs. Non-SCs/STs,0,0,0,0,0
Karnataka,14.4.2 - Other Caste Riots,122,115,40,0,277
Karnataka,14.5 - Agrarian,65,102,78,11,256
Karnataka,14.6 - Students,15,0,0,0,15
Karnataka,14.7 - Sectarian,0,0,0,0,0
Karnataka,14.8 - Other Riots,9248,10341,4356,526,24471
Karnataka,15 - Criminal Breach of Trust (Section 406 to 409 IPC),224,416,78,7,725
Karnataka,16 - Cheating (Section 420 IPC),2513,3707,1608,189,8017
Karnataka,"17 - Forgery (Section 465, 468 & 471 IPC)",104,143,58,4,309
Karnataka,"18 - Counterfeiting (Section 231-235,237-240, 242-243, 255 and 489-A to 489-E IPC)",50,28,13,0,91
Karnataka,"18.1 - Offences related to Counterfeit Coin (Section 231-235,237, 238-240 & 242-243 IPC)",0,0,0,0,0
Karnataka,18.2 - Counterfeiting Government Stamp (Section 255 IPC),0,1,0,0,1
Karnataka,18.3 - Counterfeit currency & Bank notes (Section 489-A to 489-E IPC),50,27,13,0,90
Karnataka,18.3.1 - Counterfeiting currency notes or Bank notes (Section 489A IPC),38,19,5,0,62
Karnataka,18.3.2 - Using forged or counterfeit currency/Bank notes (Section 489B IPC),9,7,1,0,17
Karnataka,18.3.3 - Possession of forged or counterfeiting currency / Bank notes (Section 489C IPC),2,1,7,0,10
Karnataka,18.3.4 - Make/Possess materials for forging or counterfeiting currency/Bank notes (Section 489D IPC),0,0,0,0,0
Karnataka,18.3.5 - Make/Use documents resembling currency notes/Bank notes (Section 489 E IPC),1,0,0,0,1
Karnataka,19 - Arson (Section 435-436 & 438 IPC),206,1048,158,4,1416
Karnataka,"20 - Grievous Hurt (Section 325,326,326A & 326 B IPC)",1937,1787,774,37,4535
Karnataka,20.1 - Grievous Hurt (Section 325 & 326 IPC),1934,1783,774,37,4528
Karnataka,20.2 - Acid attack (Section 326A IPC),2,3,0,0,5
Karnataka,20.3 - Attempt to Acid Attack (Section 326B IPC),1,1,0,0,2
Karnataka,21 - Dowry Deaths (Section 304-B IPC),204,317,127,27,675
Karnataka,22 - Assault on women with intent to outrage her Modesty (Section 354 IPC),3692,3421,1272,94,8479
Karnataka,22.1 - Sexual Harassment (Section 354A IPC),153,151,48,4,356
Karnataka,22.2 - Assault on women with intent to Disrobe (Section 354B IPC),82,133,54,3,272
Karnataka,22.3 - Voyeurism (Section 354C IPC),8,0,2,0,10
Karnataka,22.4 - Stalking (Section 354D IPC),42,23,5,0,70
Karnataka,22.5 - Others,3407,3114,1163,87,7771
Karnataka,23 - Insult to the Modesty of Women (Section 509 IPC),96,87,6,1,190
Karnataka,23.1 - At Office premises,2,2,1,0,5
Karnataka,23.2 - Places related to work other than Office,2,10,0,0,12
Karnataka,23.3 - In Public Transport system,1,1,0,0,2
Karnataka,23.4 - in Other Places,91,74,5,1,171
Karnataka,24 - Cruelty by Husband or his Relatives (Section 498-A IPC),1947,2479,911,186,5523
Karnataka,25 - Importation of Girls from Foreign Country (Section 366-B IPC),0,0,0,0,0
Karnataka,26 - Causing Death by Negligence (Section 304-A IPC),4359,4194,1277,63,9893
Karnataka,26.1 - Deaths due to negligent driving/act,4153,3793,1175,54,9175
Karnataka,26.2 - Deaths due to Other Causes,206,401,102,9,718
Karnataka,"27 - Offences against State (Section 121, 121A, 122, 123, 124-A IPC)",0,0,0,0,0
Karnataka,27.1 - Sedition (Section 124A IPC),0,0,0,0,0
Karnataka,27.2 - Other offences against State,0,0,0,0,0
Karnataka,28 - Offences promoting enmity between different groups (Section 153A & 153B IPC),48,11,3,1,63
Karnataka,28.1 - Promoting enmity on ground of religion race and place of Birth (Section 153A IPC),48,11,3,1,63
Karnataka,28.2 - Imputation & assertions prejudicial to national integration (Section 153B IPC),0,0,0,0,0
Karnataka,29 - Extortion (Section 384 - 389 IPC),119,77,16,4,216
Karnataka,30 - Disclosure of Identity of Victims (Section 228 A IPC),0,0,0,0,0
Karnataka,31 - Incidence of Rash Driving (Section 279 IPC Read with 337 & 338),14564,13711,4738,272,33285
Karnataka,32 - Human Trafficking (Section 370 & 370A IPC),103,83,6,0,192
Karnataka,33 - Unnatural Offences U/s 377 IPC,8,4,0,2,14
Karnataka,34 - Other IPC crimes,27074,26596,10479,805,64954
Karnataka,35 - Total Cognizable IPC crimes,89464,82983,29798,2527,204772
Kerala,1 - Murder (Section 302 IPC),197,323,120,18,658
Kerala,2 - Attempt to commit Murder (Section 307 IPC),605,817,235,29,1686
Kerala,3 - Culpable Homicide not amounting to Murder (Section 304 IPC),41,82,26,1,150
Kerala,4 - Attempt to commit Culpable Homicide (Section 308 IPC),818,950,345,30,2143
Kerala,5 - Rape (Section 376 IPC),585,608,174,31,1398
Kerala,5.1 - Custodial Rape,0,0,0,0,0
Kerala,5.1.1 - Gang Rape,0,0,0,0,0
Kerala,5.1.2 - Other Rape,0,0,0,0,0
Kerala,5.2 - Rape other than Custodial,585,608,174,31,1398
Kerala,5.2.1 - Gang Rape,19,20,7,1,47
Kerala,5.2.2 - Other Rape,566,588,167,30,1351
Kerala,6 - Attempt to commit Rape (Section 376/511 IPC),14,18,2,0,34
Kerala,"7 - Kidnapping & Abduction_Total (Section 3,364,364A, 366-369 IPC)",196,124,25,0,345
Kerala,7.1 - Kidnapping & Abduction (Section 363 IPC),31,16,3,0,50
Kerala,7.2 - Kidnaping & Abduction in order to Murder (Section 364 IPC),0,0,0,0,0
Kerala,7.3 - Kidnapping for Ransom (Section 364A IPC),13,8,0,0,21
Kerala,7.4 - Kidnapping & Abduction of Women to compel her for marriage (Section 366 IPC),82,17,6,0,105
Kerala,7.5 - Other Kidnapping,70,83,16,0,169
Kerala,"8 - Dacoity (Section 395,396-398 IPC)",107,119,13,0,239
Kerala,8.1 - Dacoity with Murder (Section 396 IPC),0,6,0,0,6
Kerala,8.2 - Other Dacoity,107,113,13,0,233
Kerala,9 - Making Preparation and Assembly for committing Dacoity (Section 399 & 402 IPC),130,133,46,1,310
Kerala,"10 - Robbery (Section 392 to 394, 397 and 398 IPC)",404,404,104,7,919
Kerala,11 - Criminal Trespass/Burglary_Total (Section 453 to 460 IPC),878,1193,415,29,2515
Kerala,"11.1 - Criminal Trespass/Burglary (Section 455, 457 & 458 IPC)",664,880,286,22,1852
Kerala,"11.2 - House Trespass & House Breaking (Section 453,454,456,459 & 460 IPC)",214,313,129,7,663
Kerala,12 - Theft (Section 379 to 382 IPC),1520,1668,489,38,3715
Kerala,12.1 - Auto Theft,453,434,81,0,968
Kerala,12.2 - Other Thefts,1067,1234,408,38,2747
Kerala,"13 - Unlawful Assembly (Section 143,144 & 145)",2234,2480,919,59,5692
Kerala,"14 - Riots (Section 147, 148, 149, 150 & 151 IPC)",10424,12035,4324,379,27162
Kerala,14.1 - Communal,35,537,10,0,582
Kerala,14.2 - Industrial,0,0,0,0,0
Kerala,14.3 - Political,1646,1474,517,21,3658
Kerala,14.4 - Caste Conflict,0,0,0,0,0
Kerala,14.4.1 - SC/STs Vs. Non-SCs/STs,0,0,0,0,0
Kerala,14.4.2 - Other Caste Riots,0,0,0,0,0
Kerala,14.5 - Agrarian,0,0,0,0,0
Kerala,14.6 - Students,744,0,0,0,744
Kerala,14.7 - Sectarian,0,0,0,0,0
Kerala,14.8 - Other Riots,7999,10024,3797,358,22178
Kerala,15 - Criminal Breach of Trust (Section 406 to 409 IPC),29,257,151,3,440
Kerala,16 - Cheating (Section 420 IPC),653,3297,2469,145,6564
Kerala,"17 - Forgery (Section 465, 468 & 471 IPC)",10,67,33,6,116
Kerala,"18 - Counterfeiting (Section 231-235,237-240, 242-243, 255 and 489-A to 489-E IPC)",22,29,10,0,61
Kerala,"18.1 - Offences related to Counterfeit Coin (Section 231-235,237, 238-240 & 242-243 IPC)",0,0,0,0,0
Kerala,18.2 - Counterfeiting Government Stamp (Section 255 IPC),0,0,0,0,0
Kerala,18.3 - Counterfeit currency & Bank notes (Section 489-A to 489-E IPC),22,29,10,0,61
Kerala,18.3.1 - Counterfeiting currency notes or Bank notes (Section 489A IPC),11,18,6,0,35
Kerala,18.3.2 - Using forged or counterfeit currency/Bank notes (Section 489B IPC),6,9,2,0,17
Kerala,18.3.3 - Possession of forged or counterfeiting currency / Bank notes (Section 489C IPC),4,2,1,0,7
Kerala,18.3.4 - Make/Possess materials for forging or counterfeiting currency/Bank notes (Section 489D IPC),0,0,0,0,0
Kerala,18.3.5 - Make/Use documents resembling currency notes/Bank notes (Section 489 E IPC),1,0,1,0,2
Kerala,19 - Arson (Section 435-436 & 438 IPC),175,286,73,1,535
Kerala,"20 - Grievous Hurt (Section 325,326,326A & 326 B IPC)",780,1075,487,25,2367
Kerala,20.1 - Grievous Hurt (Section 325 & 326 IPC),780,1073,485,25,2363
Kerala,20.2 - Acid attack (Section 326A IPC),0,2,2,0,4
Kerala,20.3 - Attempt to Acid Attack (Section 326B IPC),0,0,0,0,0
Kerala,21 - Dowry Deaths (Section 304-B IPC),8,35,9,4,56
Kerala,22 - Assault on women with intent to outrage her Modesty (Section 354 IPC),1691,2182,756,81,4710
Kerala,22.1 - Sexual Harassment (Section 354A IPC),493,462,107,5,1067
Kerala,22.2 - Assault on women with intent to Disrobe (Section 354B IPC),91,221,64,22,398
Kerala,22.3 - Voyeurism (Section 354C IPC),10,6,3,0,19
Kerala,22.4 - Stalking (Section 354D IPC),8,27,1,0,36
Kerala,22.5 - Others,1089,1466,581,54,3190
Kerala,23 - Insult to the Modesty of Women (Section 509 IPC),123,132,43,1,299
Kerala,23.1 - At Office premises,0,3,3,0,6
Kerala,23.2 - Places related to work other than Office,3,0,0,0,3
Kerala,23.3 - In Public Transport system,2,4,6,0,12
Kerala,23.4 - in Other Places,118,125,34,1,278
Kerala,24 - Cruelty by Husband or his Relatives (Section 498-A IPC),926,3689,2046,157,6818
Kerala,25 - Importation of Girls from Foreign Country (Section 366-B IPC),0,0,0,0,0
Kerala,26 - Causing Death by Negligence (Section 304-A IPC),1221,1572,642,51,3486
Kerala,26.1 - Deaths due to negligent driving/act,1215,1518,622,50,3405
Kerala,26.2 - Deaths due to Other Causes,6,54,20,1,81
Kerala,"27 - Offences against State (Section 121, 121A, 122, 123, 124-A IPC)",5,3,0,0,8
Kerala,27.1 - Sedition (Section 124A IPC),4,0,0,0,4
Kerala,27.2 - Other offences against State,1,3,0,0,4
Kerala,28 - Offences promoting enmity between different groups (Section 153A & 153B IPC),40,40,9,1,90
Kerala,28.1 - Promoting enmity on ground of religion race and place of Birth (Section 153A IPC),40,38,6,1,85
Kerala,28.2 - Imputation & assertions prejudicial to national integration (Section 153B IPC),0,2,3,0,5
Kerala,29 - Extortion (Section 384 - 389 IPC),22,34,3,0,59
Kerala,30 - Disclosure of Identity of Victims (Section 228 A IPC),0,0,0,0,0
Kerala,31 - Incidence of Rash Driving (Section 279 IPC Read with 337 & 338),50574,41893,16896,1221,110584
Kerala,32 - Human Trafficking (Section 370 & 370A IPC),4,9,2,1,16
Kerala,33 - Unnatural Offences U/s 377 IPC,32,52,43,5,132
Kerala,34 - Other IPC crimes,24761,26508,12112,949,64330
Kerala,35 - Total Cognizable IPC crimes,99229,102114,43021,3273,247637
Madhya Pradesh,1 - Murder (Section 302 IPC),1770,1906,728,95,4499
Madhya Pradesh,2 - Attempt to commit Murder (Section 307 IPC),2773,2430,1110,117,6430
Madhya Pradesh,3 - Culpable Homicide not amounting to Murder (Section 304 IPC),93,120,58,0,271
Madhya Pradesh,4 - Attempt to commit Culpable Homicide (Section 308 IPC),104,87,35,6,232
Madhya Pradesh,5 - Rape (Section 376 IPC),3892,1915,503,25,6335
Madhya Pradesh,5.1 - Custodial Rape,0,0,0,0,0
Madhya Pradesh,5.1.1 - Gang Rape,0,0,0,0,0
Madhya Pradesh,5.1.2 - Other Rape,0,0,0,0,0
Madhya Pradesh,5.2 - Rape other than Custodial,3892,1915,503,25,6335
Madhya Pradesh,5.2.1 - Gang Rape,401,230,29,0,660
Madhya Pradesh,5.2.2 - Other Rape,3491,1685,474,25,5675
Madhya Pradesh,6 - Attempt to commit Rape (Section 376/511 IPC),32,25,3,0,60
Madhya Pradesh,"7 - Kidnapping & Abduction_Total (Section 3,364,364A, 366-369 IPC)",2430,1438,313,13,4194
Madhya Pradesh,7.1 - Kidnapping & Abduction (Section 363 IPC),877,394,60,0,1331
Madhya Pradesh,7.2 - Kidnaping & Abduction in order to Murder (Section 364 IPC),8,10,11,3,32
Madhya Pradesh,7.3 - Kidnapping for Ransom (Section 364A IPC),27,38,18,1,84
Madhya Pradesh,7.4 - Kidnapping & Abduction of Women to compel her for marriage (Section 366 IPC),852,594,139,7,1592
Madhya Pradesh,7.5 - Other Kidnapping,666,402,85,2,1155
Madhya Pradesh,"8 - Dacoity (Section 395,396-398 IPC)",325,411,63,0,799
Madhya Pradesh,8.1 - Dacoity with Murder (Section 396 IPC),3,2,0,0,5
Madhya Pradesh,8.2 - Other Dacoity,322,409,63,0,794
Madhya Pradesh,9 - Making Preparation and Assembly for committing Dacoity (Section 399 & 402 IPC),511,340,94,10,955
Madhya Pradesh,"10 - Robbery (Section 392 to 394, 397 and 398 IPC)",1736,1117,213,18,3084
Madhya Pradesh,11 - Criminal Trespass/Burglary_Total (Section 453 to 460 IPC),3832,2352,787,35,7006
Madhya Pradesh,"11.1 - Criminal Trespass/Burglary (Section 455, 457 & 458 IPC)",3321,1859,632,35,5847
Madhya Pradesh,"11.2 - House Trespass & House Breaking (Section 453,454,456,459 & 460 IPC)",511,493,155,0,1159
Madhya Pradesh,12 - Theft (Section 379 to 382 IPC),7852,5217,1425,55,14549
Madhya Pradesh,12.1 - Auto Theft,2738,1797,293,10,4838
Madhya Pradesh,12.2 - Other Thefts,5114,3420,1132,45,9711
Madhya Pradesh,"13 - Unlawful Assembly (Section 143,144 & 145)",42,35,7,0,84
Madhya Pradesh,"14 - Riots (Section 147, 148, 149, 150 & 151 IPC)",5280,4882,2047,263,12472
Madhya Pradesh,14.1 - Communal,138,110,6,1,255
Madhya Pradesh,14.2 - Industrial,29,50,20,0,99
Madhya Pradesh,14.3 - Political,19,35,8,0,62
Madhya Pradesh,14.4 - Caste Conflict,555,396,150,23,1124
Madhya Pradesh,14.4.1 - SC/STs Vs. Non-SCs/STs,41,20,0,0,61
Madhya Pradesh,14.4.2 - Other Caste Riots,514,376,150,23,1063
Madhya Pradesh,14.5 - Agrarian,64,77,17,4,162
Madhya Pradesh,14.6 - Students,0,0,0,0,0
Madhya Pradesh,14.7 - Sectarian,0,0,0,0,0
Madhya Pradesh,14.8 - Other Riots,4475,4214,1846,235,10770
Madhya Pradesh,15 - Criminal Breach of Trust (Section 406 to 409 IPC),262,402,147,6,817
Madhya Pradesh,16 - Cheating (Section 420 IPC),788,1418,648,43,2897
Madhya Pradesh,"17 - Forgery (Section 465, 468 & 471 IPC)",87,140,59,8,294
Madhya Pradesh,"18 - Counterfeiting (Section 231-235,237-240, 242-243, 255 and 489-A to 489-E IPC)",32,28,3,0,63
Madhya Pradesh,"18.1 - Offences related to Counterfeit Coin (Section 231-235,237, 238-240 & 242-243 IPC)",0,0,0,0,0
Madhya Pradesh,18.2 - Counterfeiting Government Stamp (Section 255 IPC),0,0,0,0,0
Madhya Pradesh,18.3 - Counterfeit currency & Bank notes (Section 489-A to 489-E IPC),32,28,3,0,63
Madhya Pradesh,18.3.1 - Counterfeiting currency notes or Bank notes (Section 489A IPC),10,6,0,0,16
Madhya Pradesh,18.3.2 - Using forged or counterfeit currency/Bank notes (Section 489B IPC),16,15,1,0,32
Madhya Pradesh,18.3.3 - Possession of forged or counterfeiting currency / Bank notes (Section 489C IPC),3,0,0,0,3
Madhya Pradesh,18.3.4 - Make/Possess materials for forging or counterfeiting currency/Bank notes (Section 489D IPC),2,6,2,0,10
Madhya Pradesh,18.3.5 - Make/Use documents resembling currency notes/Bank notes (Section 489 E IPC),1,1,0,0,2
Madhya Pradesh,19 - Arson (Section 435-436 & 438 IPC),575,603,147,11,1336
Madhya Pradesh,"20 - Grievous Hurt (Section 325,326,326A & 326 B IPC)",11191,8745,3389,488,23813
Madhya Pradesh,20.1 - Grievous Hurt (Section 325 & 326 IPC),11176,8739,3386,488,23789
Madhya Pradesh,20.2 - Acid attack (Section 326A IPC),13,6,1,0,20
Madhya Pradesh,20.3 - Attempt to Acid Attack (Section 326B IPC),2,0,2,0,4
Madhya Pradesh,21 - Dowry Deaths (Section 304-B IPC),736,664,499,103,2002
Madhya Pradesh,22 - Assault on women with intent to outrage her Modesty (Section 354 IPC),6960,3743,965,57,11725
Madhya Pradesh,22.1 - Sexual Harassment (Section 354A IPC),2572,1354,295,9,4230
Madhya Pradesh,22.2 - Assault on women with intent to Disrobe (Section 354B IPC),114,55,3,0,172
Madhya Pradesh,22.3 - Voyeurism (Section 354C IPC),74,24,4,0,102
Madhya Pradesh,22.4 - Stalking (Section 354D IPC),287,117,19,0,423
Madhya Pradesh,22.5 - Others,3913,2193,644,48,6798
Madhya Pradesh,23 - Insult to the Modesty of Women (Section 509 IPC),404,179,21,4,608
Madhya Pradesh,23.1 - At Office premises,0,0,1,0,1
Madhya Pradesh,23.2 - Places related to work other than Office,22,27,0,0,49
Madhya Pradesh,23.3 - In Public Transport system,2,0,1,0,3
Madhya Pradesh,23.4 - in Other Places,380,152,19,4,555
Madhya Pradesh,24 - Cruelty by Husband or his Relatives (Section 498-A IPC),5782,5672,3609,716,15779
Madhya Pradesh,25 - Importation of Girls from Foreign Country (Section 366-B IPC),5,3,0,0,8
Madhya Pradesh,26 - Causing Death by Negligence (Section 304-A IPC),3607,3022,1068,30,7727
Madhya Pradesh,26.1 - Deaths due to negligent driving/act,3328,2635,991,24,6978
Madhya Pradesh,26.2 - Deaths due to Other Causes,279,387,77,6,749
Madhya Pradesh,"27 - Offences against State (Section 121, 121A, 122, 123, 124-A IPC)",0,0,0,0,0
Madhya Pradesh,27.1 - Sedition (Section 124A IPC),0,0,0,0,0
Madhya Pradesh,27.2 - Other offences against State,0,0,0,0,0
Madhya Pradesh,28 - Offences promoting enmity between different groups (Section 153A & 153B IPC),4,6,0,0,10
Madhya Pradesh,28.1 - Promoting enmity on ground of religion race and place of Birth (Section 153A IPC),2,4,0,0,6
Madhya Pradesh,28.2 - Imputation & assertions prejudicial to national integration (Section 153B IPC),2,2,0,0,4
Madhya Pradesh,29 - Extortion (Section 384 - 389 IPC),73,59,17,0,149
Madhya Pradesh,30 - Disclosure of Identity of Victims (Section 228 A IPC),0,0,0,0,0
Madhya Pradesh,31 - Incidence of Rash Driving (Section 279 IPC Read with 337 & 338),14828,14209,5488,412,34937
Madhya Pradesh,32 - Human Trafficking (Section 370 & 370A IPC),70,59,4,1,134
Madhya Pradesh,33 - Unnatural Offences U/s 377 IPC,83,27,6,0,116
Madhya Pradesh,34 - Other IPC crimes,103163,85395,35629,4203,228390
Madhya Pradesh,35 - Total Cognizable IPC crimes,179322,146649,59085,6719,391775
Maharashtra,1 - Murder (Section 302 IPC),2490,2043,896,163,5592
Maharashtra,2 - Attempt to commit Murder (Section 307 IPC),3904,2875,1403,243,8425
Maharashtra,3 - Culpable Homicide not amounting to Murder (Section 304 IPC),85,150,49,8,292
Maharashtra,4 - Attempt to commit Culpable Homicide (Section 308 IPC),11,19,4,0,34
Maharashtra,5 - Rape (Section 376 IPC),2548,1312,410,71,4341
Maharashtra,5.1 - Custodial Rape,0,0,0,0,0
Maharashtra,5.1.1 - Gang Rape,0,0,0,0,0
Maharashtra,5.1.2 - Other Rape,0,0,0,0,0
Maharashtra,5.2 - Rape other than Custodial,2548,1312,410,71,4341
Maharashtra,5.2.1 - Gang Rape,232,84,29,2,347
Maharashtra,5.2.2 - Other Rape,2316,1228,381,69,3994
Maharashtra,6 - Attempt to commit Rape (Section 376/511 IPC),13,5,1,0,19
Maharashtra,"7 - Kidnapping & Abduction_Total (Section 3,364,364A, 366-369 IPC)",1856,1057,299,33,3245
Maharashtra,7.1 - Kidnapping & Abduction (Section 363 IPC),750,363,89,13,1215
Maharashtra,7.2 - Kidnaping & Abduction in order to Murder (Section 364 IPC),14,10,2,0,26
Maharashtra,7.3 - Kidnapping for Ransom (Section 364A IPC),27,38,3,2,70
Maharashtra,7.4 - Kidnapping & Abduction of Women to compel her for marriage (Section 366 IPC),620,390,146,9,1165
Maharashtra,7.5 - Other Kidnapping,445,256,59,9,769
Maharashtra,"8 - Dacoity (Section 395,396-398 IPC)",2276,1497,484,59,4316
Maharashtra,8.1 - Dacoity with Murder (Section 396 IPC),41,17,2,1,61
Maharashtra,8.2 - Other Dacoity,2235,1480,482,58,4255
Maharashtra,9 - Making Preparation and Assembly for committing Dacoity (Section 399 & 402 IPC),993,344,52,1,1390
Maharashtra,"10 - Robbery (Section 392 to 394, 397 and 398 IPC)",6699,2361,627,37,9724
Maharashtra,11 - Criminal Trespass/Burglary_Total (Section 453 to 460 IPC),6650,3153,978,43,10824
Maharashtra,"11.1 - Criminal Trespass/Burglary (Section 455, 457 & 458 IPC)",4769,2235,765,33,7802
Maharashtra,"11.2 - House Trespass & House Breaking (Section 453,454,456,459 & 460 IPC)",1881,918,213,10,3022
Maharashtra,12 - Theft (Section 379 to 382 IPC),18624,9313,2742,239,30918
Maharashtra,12.1 - Auto Theft,4804,1950,332,14,7100
Maharashtra,12.2 - Other Thefts,13820,7363,2410,225,23818
Maharashtra,"13 - Unlawful Assembly (Section 143,144 & 145)",3095,3033,1492,206,7826
Maharashtra,"14 - Riots (Section 147, 148, 149, 150 & 151 IPC)",20878,17063,7782,1503,47226
Maharashtra,14.1 - Communal,400,317,127,12,856
Maharashtra,14.2 - Industrial,27,5,0,0,32
Maharashtra,14.3 - Political,449,454,148,11,1062
Maharashtra,14.4 - Caste Conflict,685,1130,585,14,2414
Maharashtra,14.4.1 - SC/STs Vs. Non-SCs/STs,317,423,148,13,901
Maharashtra,14.4.2 - Other Caste Riots,368,707,437,1,1513
Maharashtra,14.5 - Agrarian,212,154,94,11,471
Maharashtra,14.6 - Students,31,5,1,0,37
Maharashtra,14.7 - Sectarian,0,0,0,0,0
Maharashtra,14.8 - Other Riots,19074,14998,6827,1455,42354
Maharashtra,15 - Criminal Breach of Trust (Section 406 to 409 IPC),829,1204,403,44,2480
Maharashtra,16 - Cheating (Section 420 IPC),3131,5031,2135,339,10636
Maharashtra,"17 - Forgery (Section 465, 468 & 471 IPC)",376,498,257,61,1192
Maharashtra,"18 - Counterfeiting (Section 231-235,237-240, 242-243, 255 and 489-A to 489-E IPC)",131,80,13,1,225
Maharashtra,"18.1 - Offences related to Counterfeit Coin (Section 231-235,237, 238-240 & 242-243 IPC)",0,0,0,0,0
Maharashtra,18.2 - Counterfeiting Government Stamp (Section 255 IPC),0,0,0,0,0
Maharashtra,18.3 - Counterfeit currency & Bank notes (Section 489-A to 489-E IPC),131,80,13,1,225
Maharashtra,18.3.1 - Counterfeiting currency notes or Bank notes (Section 489A IPC),73,52,12,1,138
Maharashtra,18.3.2 - Using forged or counterfeit currency/Bank notes (Section 489B IPC),43,20,1,0,64
Maharashtra,18.3.3 - Possession of forged or counterfeiting currency / Bank notes (Section 489C IPC),15,8,0,0,23
Maharashtra,18.3.4 - Make/Possess materials for forging or counterfeiting currency/Bank notes (Section 489D IPC),0,0,0,0,0
Maharashtra,18.3.5 - Make/Use documents resembling currency notes/Bank notes (Section 489 E IPC),0,0,0,0,0
Maharashtra,19 - Arson (Section 435-436 & 438 IPC),472,545,190,26,1233
Maharashtra,"20 - Grievous Hurt (Section 325,326,326A & 326 B IPC)",7976,6023,2239,358,16596
Maharashtra,20.1 - Grievous Hurt (Section 325 & 326 IPC),7973,6022,2239,358,16592
Maharashtra,20.2 - Acid attack (Section 326A IPC),3,1,0,0,4
Maharashtra,20.3 - Attempt to Acid Attack (Section 326B IPC),0,0,0,0,0
Maharashtra,21 - Dowry Deaths (Section 304-B IPC),325,342,208,59,934
Maharashtra,22 - Assault on women with intent to outrage her Modesty (Section 354 IPC),6422,4230,1314,184,12150
Maharashtra,22.1 - Sexual Harassment (Section 354A IPC),2591,1495,495,80,4661
Maharashtra,22.2 - Assault on women with intent to Disrobe (Section 354B IPC),269,123,34,6,432
Maharashtra,22.3 - Voyeurism (Section 354C IPC),62,33,7,1,103
Maharashtra,22.4 - Stalking (Section 354D IPC),531,231,62,4,828
Maharashtra,22.5 - Others,2969,2348,716,93,6126
Maharashtra,23 - Insult to the Modesty of Women (Section 509 IPC),1070,625,167,25,1887
Maharashtra,23.1 - At Office premises,8,1,2,0,11
Maharashtra,23.2 - Places related to work other than Office,25,13,6,1,45
Maharashtra,23.3 - In Public Transport system,7,3,0,0,10
Maharashtra,23.4 - in Other Places,1030,608,159,24,1821
Maharashtra,24 - Cruelty by Husband or his Relatives (Section 498-A IPC),8111,9043,5697,1842,24693
Maharashtra,25 - Importation of Girls from Foreign Country (Section 366-B IPC),1,0,1,0,2
Maharashtra,26 - Causing Death by Negligence (Section 304-A IPC),4063,3987,1477,108,9635
Maharashtra,26.1 - Deaths due to negligent driving/act,3830,3642,1359,97,8928
Maharashtra,26.2 - Deaths due to Other Causes,233,345,118,11,707
Maharashtra,"27 - Offences against State (Section 121, 121A, 122, 123, 124-A IPC)",0,0,0,0,0
Maharashtra,27.1 - Sedition (Section 124A IPC),0,0,0,0,0
Maharashtra,27.2 - Other offences against State,0,0,0,0,0
Maharashtra,28 - Offences promoting enmity between different groups (Section 153A & 153B IPC),32,76,80,16,204
Maharashtra,28.1 - Promoting enmity on ground of religion race and place of Birth (Section 153A IPC),32,75,80,16,203
Maharashtra,28.2 - Imputation & assertions prejudicial to national integration (Section 153B IPC),0,1,0,0,1
Maharashtra,29 - Extortion (Section 384 - 389 IPC),550,489,92,10,1141
Maharashtra,30 - Disclosure of Identity of Victims (Section 228 A IPC),0,0,0,0,0
Maharashtra,31 - Incidence of Rash Driving (Section 279 IPC Read with 337 & 338),11817,8717,3173,179,23886
Maharashtra,32 - Human Trafficking (Section 370 & 370A IPC),117,134,44,3,298
Maharashtra,33 - Unnatural Offences U/s 377 IPC,51,26,4,1,82
Maharashtra,34 - Other IPC crimes,41134,32364,14109,2308,89915
Maharashtra,35 - Total Cognizable IPC crimes,156730,117639,48822,8170,331361
Manipur,1 - Murder (Section 302 IPC),16,26,11,1,54
Manipur,2 - Attempt to commit Murder (Section 307 IPC),62,47,15,3,127
Manipur,3 - Culpable Homicide not amounting to Murder (Section 304 IPC),0,1,0,0,1
Manipur,4 - Attempt to commit Culpable Homicide (Section 308 IPC),0,0,0,0,0
Manipur,5 - Rape (Section 376 IPC),31,22,11,3,67
Manipur,5.1 - Custodial Rape,0,0,0,0,0
Manipur,5.1.1 - Gang Rape,0,0,0,0,0
Manipur,5.1.2 - Other Rape,0,0,0,0,0
Manipur,5.2 - Rape other than Custodial,31,22,11,3,67
Manipur,5.2.1 - Gang Rape,0,0,0,0,0
Manipur,5.2.2 - Other Rape,31,22,11,3,67
Manipur,6 - Attempt to commit Rape (Section 376/511 IPC),0,0,0,0,0
Manipur,"7 - Kidnapping & Abduction_Total (Section 3,364,364A, 366-369 IPC)",48,36,8,0,92
Manipur,7.1 - Kidnapping & Abduction (Section 363 IPC),1,0,0,0,1
Manipur,7.2 - Kidnaping & Abduction in order to Murder (Section 364 IPC),0,0,0,0,0
Manipur,7.3 - Kidnapping for Ransom (Section 364A IPC),6,5,0,0,11
Manipur,7.4 - Kidnapping & Abduction of Women to compel her for marriage (Section 366 IPC),37,21,7,0,65
Manipur,7.5 - Other Kidnapping,4,10,1,0,15
Manipur,"8 - Dacoity (Section 395,396-398 IPC)",0,0,0,0,0
Manipur,8.1 - Dacoity with Murder (Section 396 IPC),0,0,0,0,0
Manipur,8.2 - Other Dacoity,0,0,0,0,0
Manipur,9 - Making Preparation and Assembly for committing Dacoity (Section 399 & 402 IPC),0,0,0,0,0
Manipur,"10 - Robbery (Section 392 to 394, 397 and 398 IPC)",2,5,0,0,7
Manipur,11 - Criminal Trespass/Burglary_Total (Section 453 to 460 IPC),3,12,1,0,16
Manipur,"11.1 - Criminal Trespass/Burglary (Section 455, 457 & 458 IPC)",2,10,0,0,12
Manipur,"11.2 - House Trespass & House Breaking (Section 453,454,456,459 & 460 IPC)",1,2,1,0,4
Manipur,12 - Theft (Section 379 to 382 IPC),101,90,49,0,240
Manipur,12.1 - Auto Theft,68,64,35,0,167
Manipur,12.2 - Other Thefts,33,26,14,0,73
Manipur,"13 - Unlawful Assembly (Section 143,144 & 145)",0,0,0,0,0
Manipur,"14 - Riots (Section 147, 148, 149, 150 & 151 IPC)",49,16,15,19,99
Manipur,14.1 - Communal,0,2,0,0,2
Manipur,14.2 - Industrial,0,0,0,0,0
Manipur,14.3 - Political,0,0,0,0,0
Manipur,14.4 - Caste Conflict,0,0,0,0,0
Manipur,14.4.1 - SC/STs Vs. Non-SCs/STs,0,0,0,0,0
Manipur,14.4.2 - Other Caste Riots,0,0,0,0,0
Manipur,14.5 - Agrarian,0,0,0,0,0
Manipur,14.6 - Students,7,0,0,0,7
Manipur,14.7 - Sectarian,0,0,0,0,0
Manipur,14.8 - Other Riots,42,14,15,19,90
Manipur,15 - Criminal Breach of Trust (Section 406 to 409 IPC),4,9,3,0,16
Manipur,16 - Cheating (Section 420 IPC),14,24,5,0,43
Manipur,"17 - Forgery (Section 465, 468 & 471 IPC)",5,15,1,0,21
Manipur,"18 - Counterfeiting (Section 231-235,237-240, 242-243, 255 and 489-A to 489-E IPC)",0,5,0,0,5
Manipur,"18.1 - Offences related to Counterfeit Coin (Section 231-235,237, 238-240 & 242-243 IPC)",0,0,0,0,0
Manipur,18.2 - Counterfeiting Government Stamp (Section 255 IPC),0,0,0,0,0
Manipur,18.3 - Counterfeit currency & Bank notes (Section 489-A to 489-E IPC),0,5,0,0,5
Manipur,18.3.1 - Counterfeiting currency notes or Bank notes (Section 489A IPC),0,0,0,0,0
Manipur,18.3.2 - Using forged or counterfeit currency/Bank notes (Section 489B IPC),0,2,0,0,2
Manipur,18.3.3 - Possession of forged or counterfeiting currency / Bank notes (Section 489C IPC),0,3,0,0,3
Manipur,18.3.4 - Make/Possess materials for forging or counterfeiting currency/Bank notes (Section 489D IPC),0,0,0,0,0
Manipur,18.3.5 - Make/Use documents resembling currency notes/Bank notes (Section 489 E IPC),0,0,0,0,0
Manipur,19 - Arson (Section 435-436 & 438 IPC),8,3,0,1,12
Manipur,"20 - Grievous Hurt (Section 325,326,326A & 326 B IPC)",52,58,18,5,133
Manipur,20.1 - Grievous Hurt (Section 325 & 326 IPC),52,58,18,5,133
Manipur,20.2 - Acid attack (Section 326A IPC),0,0,0,0,0
Manipur,20.3 - Attempt to Acid Attack (Section 326B IPC),0,0,0,0,0
Manipur,21 - Dowry Deaths (Section 304-B IPC),0,1,0,0,1
Manipur,22 - Assault on women with intent to outrage her Modesty (Section 354 IPC),22,20,5,0,47
Manipur,22.1 - Sexual Harassment (Section 354A IPC),1,2,0,0,3
Manipur,22.2 - Assault on women with intent to Disrobe (Section 354B IPC),0,0,0,0,0
Manipur,22.3 - Voyeurism (Section 354C IPC),0,0,0,0,0
Manipur,22.4 - Stalking (Section 354D IPC),0,0,0,0,0
Manipur,22.5 - Others,21,18,5,0,44
Manipur,23 - Insult to the Modesty of Women (Section 509 IPC),0,0,0,0,0
Manipur,23.1 - At Office premises,0,0,0,0,0
Manipur,23.2 - Places related to work other than Office,0,0,0,0,0
Manipur,23.3 - In Public Transport system,0,0,0,0,0
Manipur,23.4 - in Other Places,0,0,0,0,0
Manipur,24 - Cruelty by Husband or his Relatives (Section 498-A IPC),3,9,6,0,18
Manipur,25 - Importation of Girls from Foreign Country (Section 366-B IPC),0,0,0,0,0
Manipur,26 - Causing Death by Negligence (Section 304-A IPC),12,44,24,5,85
Manipur,26.1 - Deaths due to negligent driving/act,11,44,24,5,84
Manipur,26.2 - Deaths due to Other Causes,1,0,0,0,1
Manipur,"27 - Offences against State (Section 121, 121A, 122, 123, 124-A IPC)",2,5,1,0,8
Manipur,27.1 - Sedition (Section 124A IPC),0,0,0,0,0
Manipur,27.2 - Other offences against State,2,5,1,0,8
Manipur,28 - Offences promoting enmity between different groups (Section 153A & 153B IPC),0,0,0,0,0
Manipur,28.1 - Promoting enmity on ground of religion race and place of Birth (Section 153A IPC),0,0,0,0,0
Manipur,28.2 - Imputation & assertions prejudicial to national integration (Section 153B IPC),0,0,0,0,0
Manipur,29 - Extortion (Section 384 - 389 IPC),20,25,5,0,50
Manipur,30 - Disclosure of Identity of Victims (Section 228 A IPC),0,0,0,0,0
Manipur,31 - Incidence of Rash Driving (Section 279 IPC Read with 337 & 338),40,74,64,3,181
Manipur,32 - Human Trafficking (Section 370 & 370A IPC),0,1,0,0,1
Manipur,33 - Unnatural Offences U/s 377 IPC,0,0,0,0,0
Manipur,34 - Other IPC crimes,107,159,107,15,388
Manipur,35 - Total Cognizable IPC crimes,601,707,349,55,1712
Meghalaya,1 - Murder (Section 302 IPC),116,49,27,0,192
Meghalaya,2 - Attempt to commit Murder (Section 307 IPC),54,49,3,0,106
Meghalaya,3 - Culpable Homicide not amounting to Murder (Section 304 IPC),5,3,3,0,11
Meghalaya,4 - Attempt to commit Culpable Homicide (Section 308 IPC),0,0,0,0,0
Meghalaya,5 - Rape (Section 376 IPC),83,53,12,3,151
Meghalaya,5.1 - Custodial Rape,0,0,0,0,0
Meghalaya,5.1.1 - Gang Rape,0,0,0,0,0
Meghalaya,5.1.2 - Other Rape,0,0,0,0,0
Meghalaya,5.2 - Rape other than Custodial,83,53,12,3,151
Meghalaya,5.2.1 - Gang Rape,3,3,0,0,6
Meghalaya,5.2.2 - Other Rape,80,50,12,3,145
Meghalaya,6 - Attempt to commit Rape (Section 376/511 IPC),12,7,1,0,20
Meghalaya,"7 - Kidnapping & Abduction_Total (Section 3,364,364A, 366-369 IPC)",112,48,1,1,162
Meghalaya,7.1 - Kidnapping & Abduction (Section 363 IPC),14,11,0,0,25
Meghalaya,7.2 - Kidnaping & Abduction in order to Murder (Section 364 IPC),0,1,0,0,1
Meghalaya,7.3 - Kidnapping for Ransom (Section 364A IPC),31,6,0,0,37
Meghalaya,7.4 - Kidnapping & Abduction of Women to compel her for marriage (Section 366 IPC),2,3,0,0,5
Meghalaya,7.5 - Other Kidnapping,65,27,1,1,94
Meghalaya,"8 - Dacoity (Section 395,396-398 IPC)",33,29,5,0,67
Meghalaya,8.1 - Dacoity with Murder (Section 396 IPC),0,0,0,0,0
Meghalaya,8.2 - Other Dacoity,33,29,5,0,67
Meghalaya,9 - Making Preparation and Assembly for committing Dacoity (Section 399 & 402 IPC),0,0,0,0,0
Meghalaya,"10 - Robbery (Section 392 to 394, 397 and 398 IPC)",67,22,2,0,91
Meghalaya,11 - Criminal Trespass/Burglary_Total (Section 453 to 460 IPC),60,15,2,0,77
Meghalaya,"11.1 - Criminal Trespass/Burglary (Section 455, 457 & 458 IPC)",30,10,2,0,42
Meghalaya,"11.2 - House Trespass & House Breaking (Section 453,454,456,459 & 460 IPC)",30,5,0,0,35
Meghalaya,12 - Theft (Section 379 to 382 IPC),336,161,23,0,520
Meghalaya,12.1 - Auto Theft,42,39,12,0,93
Meghalaya,12.2 - Other Thefts,294,122,11,0,427
Meghalaya,"13 - Unlawful Assembly (Section 143,144 & 145)",0,0,0,0,0
Meghalaya,"14 - Riots (Section 147, 148, 149, 150 & 151 IPC)",3,1,0,0,4
Meghalaya,14.1 - Communal,0,0,0,0,0
Meghalaya,14.2 - Industrial,0,0,0,0,0
Meghalaya,14.3 - Political,0,0,0,0,0
Meghalaya,14.4 - Caste Conflict,0,0,0,0,0
Meghalaya,14.4.1 - SC/STs Vs. Non-SCs/STs,0,0,0,0,0
Meghalaya,14.4.2 - Other Caste Riots,0,0,0,0,0
Meghalaya,14.5 - Agrarian,0,0,0,0,0
Meghalaya,14.6 - Students,0,0,0,0,0
Meghalaya,14.7 - Sectarian,0,0,0,0,0
Meghalaya,14.8 - Other Riots,3,1,0,0,4
Meghalaya,15 - Criminal Breach of Trust (Section 406 to 409 IPC),10,18,7,0,35
Meghalaya,16 - Cheating (Section 420 IPC),42,55,13,0,110
Meghalaya,"17 - Forgery (Section 465, 468 & 471 IPC)",8,12,5,0,25
Meghalaya,"18 - Counterfeiting (Section 231-235,237-240, 242-243, 255 and 489-A to 489-E IPC)",3,10,1,0,14
Meghalaya,"18.1 - Offences related to Counterfeit Coin (Section 231-235,237, 238-240 & 242-243 IPC)",0,0,0,0,0
Meghalaya,18.2 - Counterfeiting Government Stamp (Section 255 IPC),0,0,0,0,0
Meghalaya,18.3 - Counterfeit currency & Bank notes (Section 489-A to 489-E IPC),3,10,1,0,14
Meghalaya,18.3.1 - Counterfeiting currency notes or Bank notes (Section 489A IPC),0,0,0,0,0
Meghalaya,18.3.2 - Using forged or counterfeit currency/Bank notes (Section 489B IPC),2,5,0,0,7
Meghalaya,18.3.3 - Possession of forged or counterfeiting currency / Bank notes (Section 489C IPC),1,5,1,0,7
Meghalaya,18.3.4 - Make/Possess materials for forging or counterfeiting currency/Bank notes (Section 489D IPC),0,0,0,0,0
Meghalaya,18.3.5 - Make/Use documents resembling currency notes/Bank notes (Section 489 E IPC),0,0,0,0,0
Meghalaya,19 - Arson (Section 435-436 & 438 IPC),19,13,3,0,35
Meghalaya,"20 - Grievous Hurt (Section 325,326,326A & 326 B IPC)",142,76,17,3,238
Meghalaya,20.1 - Grievous Hurt (Section 325 & 326 IPC),142,76,17,3,238
Meghalaya,20.2 - Acid attack (Section 326A IPC),0,0,0,0,0
Meghalaya,20.3 - Attempt to Acid Attack (Section 326B IPC),0,0,0,0,0
Meghalaya,21 - Dowry Deaths (Section 304-B IPC),0,0,1,0,1
Meghalaya,22 - Assault on women with intent to outrage her Modesty (Section 354 IPC),50,39,9,0,98
Meghalaya,22.1 - Sexual Harassment (Section 354A IPC),0,0,0,0,0
Meghalaya,22.2 - Assault on women with intent to Disrobe (Section 354B IPC),6,3,1,0,10
Meghalaya,22.3 - Voyeurism (Section 354C IPC),1,0,0,0,1
Meghalaya,22.4 - Stalking (Section 354D IPC),1,2,1,0,4
Meghalaya,22.5 - Others,42,34,7,0,83
Meghalaya,23 - Insult to the Modesty of Women (Section 509 IPC),19,13,3,1,36
Meghalaya,23.1 - At Office premises,0,0,0,0,0
Meghalaya,23.2 - Places related to work other than Office,0,0,0,0,0
Meghalaya,23.3 - In Public Transport system,0,0,0,0,0
Meghalaya,23.4 - in Other Places,19,13,3,1,36
Meghalaya,24 - Cruelty by Husband or his Relatives (Section 498-A IPC),11,19,1,0,31
Meghalaya,25 - Importation of Girls from Foreign Country (Section 366-B IPC),0,0,0,0,0
Meghalaya,26 - Causing Death by Negligence (Section 304-A IPC),60,55,21,0,136
Meghalaya,26.1 - Deaths due to negligent driving/act,53,47,19,0,119
Meghalaya,26.2 - Deaths due to Other Causes,7,8,2,0,17
Meghalaya,"27 - Offences against State (Section 121, 121A, 122, 123, 124-A IPC)",60,7,0,0,67
Meghalaya,27.1 - Sedition (Section 124A IPC),0,0,0,0,0
Meghalaya,27.2 - Other offences against State,60,7,0,0,67
Meghalaya,28 - Offences promoting enmity between different groups (Section 153A & 153B IPC),0,0,0,0,0
Meghalaya,28.1 - Promoting enmity on ground of religion race and place of Birth (Section 153A IPC),0,0,0,0,0
Meghalaya,28.2 - Imputation & assertions prejudicial to national integration (Section 153B IPC),0,0,0,0,0
Meghalaya,29 - Extortion (Section 384 - 389 IPC),99,30,5,0,134
Meghalaya,30 - Disclosure of Identity of Victims (Section 228 A IPC),0,0,0,0,0
Meghalaya,31 - Incidence of Rash Driving (Section 279 IPC Read with 337 & 338),44,30,2,0,76
Meghalaya,32 - Human Trafficking (Section 370 & 370A IPC),0,0,0,0,0
Meghalaya,33 - Unnatural Offences U/s 377 IPC,0,0,0,0,0
Meghalaya,34 - Other IPC crimes,413,278,27,0,718
Meghalaya,35 - Total Cognizable IPC crimes,1861,1092,194,8,3155
Mizoram,1 - Murder (Section 302 IPC),23,16,6,1,46
Mizoram,2 - Attempt to commit Murder (Section 307 IPC),14,15,4,0,33
Mizoram,3 - Culpable Homicide not amounting to Murder (Section 304 IPC),9,0,1,0,10
Mizoram,4 - Attempt to commit Culpable Homicide (Section 308 IPC),1,0,0,0,1
Mizoram,5 - Rape (Section 376 IPC),73,36,14,3,126
Mizoram,5.1 - Custodial Rape,0,0,0,0,0
Mizoram,5.1.1 - Gang Rape,0,0,0,0,0
Mizoram,5.1.2 - Other Rape,0,0,0,0,0
Mizoram,5.2 - Rape other than Custodial,73,36,14,3,126
Mizoram,5.2.1 - Gang Rape,10,5,0,0,15
Mizoram,5.2.2 - Other Rape,63,31,14,3,111
Mizoram,6 - Attempt to commit Rape (Section 376/511 IPC),0,1,0,0,1
Mizoram,"7 - Kidnapping & Abduction_Total (Section 3,364,364A, 366-369 IPC)",3,3,1,1,8
Mizoram,7.1 - Kidnapping & Abduction (Section 363 IPC),2,3,0,1,6
Mizoram,7.2 - Kidnaping & Abduction in order to Murder (Section 364 IPC),0,0,0,0,0
Mizoram,7.3 - Kidnapping for Ransom (Section 364A IPC),1,0,0,0,1
Mizoram,7.4 - Kidnapping & Abduction of Women to compel her for marriage (Section 366 IPC),0,0,0,0,0
Mizoram,7.5 - Other Kidnapping,0,0,1,0,1
Mizoram,"8 - Dacoity (Section 395,396-398 IPC)",0,2,2,0,4
Mizoram,8.1 - Dacoity with Murder (Section 396 IPC),0,0,0,0,0
Mizoram,8.2 - Other Dacoity,0,2,2,0,4
Mizoram,9 - Making Preparation and Assembly for committing Dacoity (Section 399 & 402 IPC),0,0,0,0,0
Mizoram,"10 - Robbery (Section 392 to 394, 397 and 398 IPC)",3,3,1,0,7
Mizoram,11 - Criminal Trespass/Burglary_Total (Section 453 to 460 IPC),343,146,12,0,501
Mizoram,"11.1 - Criminal Trespass/Burglary (Section 455, 457 & 458 IPC)",208,86,5,0,299
Mizoram,"11.2 - House Trespass & House Breaking (Section 453,454,456,459 & 460 IPC)",135,60,7,0,202
Mizoram,12 - Theft (Section 379 to 382 IPC),589,254,28,2,873
Mizoram,12.1 - Auto Theft,82,13,0,1,96
Mizoram,12.2 - Other Thefts,507,241,28,1,777
Mizoram,"13 - Unlawful Assembly (Section 143,144 & 145)",0,0,0,0,0
Mizoram,"14 - Riots (Section 147, 148, 149, 150 & 151 IPC)",0,0,0,0,0
Mizoram,14.1 - Communal,0,0,0,0,0
Mizoram,14.2 - Industrial,0,0,0,0,0
Mizoram,14.3 - Political,0,0,0,0,0
Mizoram,14.4 - Caste Conflict,0,0,0,0,0
Mizoram,14.4.1 - SC/STs Vs. Non-SCs/STs,0,0,0,0,0
Mizoram,14.4.2 - Other Caste Riots,0,0,0,0,0
Mizoram,14.5 - Agrarian,0,0,0,0,0
Mizoram,14.6 - Students,0,0,0,0,0
Mizoram,14.7 - Sectarian,0,0,0,0,0
Mizoram,14.8 - Other Riots,0,0,0,0,0
Mizoram,15 - Criminal Breach of Trust (Section 406 to 409 IPC),2,12,8,0,22
Mizoram,16 - Cheating (Section 420 IPC),35,33,9,1,78
Mizoram,"17 - Forgery (Section 465, 468 & 471 IPC)",1,2,2,1,6
Mizoram,"18 - Counterfeiting (Section 231-235,237-240, 242-243, 255 and 489-A to 489-E IPC)",4,4,3,0,11
Mizoram,"18.1 - Offences related to Counterfeit Coin (Section 231-235,237, 238-240 & 242-243 IPC)",0,0,0,0,0
Mizoram,18.2 - Counterfeiting Government Stamp (Section 255 IPC),0,0,0,0,0
Mizoram,18.3 - Counterfeit currency & Bank notes (Section 489-A to 489-E IPC),4,4,3,0,11
Mizoram,18.3.1 - Counterfeiting currency notes or Bank notes (Section 489A IPC),1,0,3,0,4
Mizoram,18.3.2 - Using forged or counterfeit currency/Bank notes (Section 489B IPC),0,0,0,0,0
Mizoram,18.3.3 - Possession of forged or counterfeiting currency / Bank notes (Section 489C IPC),3,4,0,0,7
Mizoram,18.3.4 - Make/Possess materials for forging or counterfeiting currency/Bank notes (Section 489D IPC),0,0,0,0,0
Mizoram,18.3.5 - Make/Use documents resembling currency notes/Bank notes (Section 489 E IPC),0,0,0,0,0
Mizoram,19 - Arson (Section 435-436 & 438 IPC),15,16,3,0,34
Mizoram,"20 - Grievous Hurt (Section 325,326,326A & 326 B IPC)",70,35,18,1,124
Mizoram,20.1 - Grievous Hurt (Section 325 & 326 IPC),70,35,18,1,124
Mizoram,20.2 - Acid attack (Section 326A IPC),0,0,0,0,0
Mizoram,20.3 - Attempt to Acid Attack (Section 326B IPC),0,0,0,0,0
Mizoram,21 - Dowry Deaths (Section 304-B IPC),0,0,0,0,0
Mizoram,22 - Assault on women with intent to outrage her Modesty (Section 354 IPC),49,38,14,1,102
Mizoram,22.1 - Sexual Harassment (Section 354A IPC),24,20,9,1,54
Mizoram,22.2 - Assault on women with intent to Disrobe (Section 354B IPC),10,7,1,0,18
Mizoram,22.3 - Voyeurism (Section 354C IPC),1,1,0,0,2
Mizoram,22.4 - Stalking (Section 354D IPC),3,2,1,0,6
Mizoram,22.5 - Others,11,8,3,0,22
Mizoram,23 - Insult to the Modesty of Women (Section 509 IPC),8,0,0,0,8
Mizoram,23.1 - At Office premises,0,0,0,0,0
Mizoram,23.2 - Places related to work other than Office,8,0,0,0,8
Mizoram,23.3 - In Public Transport system,0,0,0,0,0
Mizoram,23.4 - in Other Places,0,0,0,0,0
Mizoram,24 - Cruelty by Husband or his Relatives (Section 498-A IPC),5,5,1,0,11
Mizoram,25 - Importation of Girls from Foreign Country (Section 366-B IPC),0,0,0,0,0
Mizoram,26 - Causing Death by Negligence (Section 304-A IPC),42,21,8,0,71
Mizoram,26.1 - Deaths due to negligent driving/act,39,20,6,0,65
Mizoram,26.2 - Deaths due to Other Causes,3,1,2,0,6
Mizoram,"27 - Offences against State (Section 121, 121A, 122, 123, 124-A IPC)",0,1,0,0,1
Mizoram,27.1 - Sedition (Section 124A IPC),0,0,0,0,0
Mizoram,27.2 - Other offences against State,0,1,0,0,1
Mizoram,28 - Offences promoting enmity between different groups (Section 153A & 153B IPC),0,1,0,0,1
Mizoram,28.1 - Promoting enmity on ground of religion race and place of Birth (Section 153A IPC),0,1,0,0,1
Mizoram,28.2 - Imputation & assertions prejudicial to national integration (Section 153B IPC),0,0,0,0,0
Mizoram,29 - Extortion (Section 384 - 389 IPC),10,15,1,0,26
Mizoram,30 - Disclosure of Identity of Victims (Section 228 A IPC),0,0,0,0,0
Mizoram,31 - Incidence of Rash Driving (Section 279 IPC Read with 337 & 338),14,5,1,0,20
Mizoram,32 - Human Trafficking (Section 370 & 370A IPC),0,0,0,0,0
Mizoram,33 - Unnatural Offences U/s 377 IPC,4,0,0,0,4
Mizoram,34 - Other IPC crimes,120,76,27,0,223
Mizoram,35 - Total Cognizable IPC crimes,1437,740,164,11,2352
Nagaland,1 - Murder (Section 302 IPC),18,23,6,0,47
Nagaland,2 - Attempt to commit Murder (Section 307 IPC),14,28,0,0,42
Nagaland,3 - Culpable Homicide not amounting to Murder (Section 304 IPC),0,2,1,0,3
Nagaland,4 - Attempt to commit Culpable Homicide (Section 308 IPC),0,0,0,0,0
Nagaland,5 - Rape (Section 376 IPC),18,18,2,2,40
Nagaland,5.1 - Custodial Rape,0,0,0,0,0
Nagaland,5.1.1 - Gang Rape,0,0,0,0,0
Nagaland,5.1.2 - Other Rape,0,0,0,0,0
Nagaland,5.2 - Rape other than Custodial,18,18,2,2,40
Nagaland,5.2.1 - Gang Rape,4,0,0,1,5
Nagaland,5.2.2 - Other Rape,14,18,2,1,35
Nagaland,6 - Attempt to commit Rape (Section 376/511 IPC),0,2,0,1,3
Nagaland,"7 - Kidnapping & Abduction_Total (Section 3,364,364A, 366-369 IPC)",18,27,6,0,51
Nagaland,7.1 - Kidnapping & Abduction (Section 363 IPC),6,1,1,0,8
Nagaland,7.2 - Kidnaping & Abduction in order to Murder (Section 364 IPC),0,0,0,0,0
Nagaland,7.3 - Kidnapping for Ransom (Section 364A IPC),4,2,0,0,6
Nagaland,7.4 - Kidnapping & Abduction of Women to compel her for marriage (Section 366 IPC),0,2,0,0,2
Nagaland,7.5 - Other Kidnapping,8,22,5,0,35
Nagaland,"8 - Dacoity (Section 395,396-398 IPC)",7,1,0,0,8
Nagaland,8.1 - Dacoity with Murder (Section 396 IPC),0,0,0,0,0
Nagaland,8.2 - Other Dacoity,7,1,0,0,8
Nagaland,9 - Making Preparation and Assembly for committing Dacoity (Section 399 & 402 IPC),0,0,0,0,0
Nagaland,"10 - Robbery (Section 392 to 394, 397 and 398 IPC)",20,21,0,0,41
Nagaland,11 - Criminal Trespass/Burglary_Total (Section 453 to 460 IPC),25,13,1,0,39
Nagaland,"11.1 - Criminal Trespass/Burglary (Section 455, 457 & 458 IPC)",22,11,0,0,33
Nagaland,"11.2 - House Trespass & House Breaking (Section 453,454,456,459 & 460 IPC)",3,2,1,0,6
Nagaland,12 - Theft (Section 379 to 382 IPC),228,151,27,1,407
Nagaland,12.1 - Auto Theft,112,63,16,0,191
Nagaland,12.2 - Other Thefts,116,88,11,1,216
Nagaland,"13 - Unlawful Assembly (Section 143,144 & 145)",0,0,0,0,0
Nagaland,"14 - Riots (Section 147, 148, 149, 150 & 151 IPC)",1,3,0,0,4
Nagaland,14.1 - Communal,0,0,0,0,0
Nagaland,14.2 - Industrial,0,0,0,0,0
Nagaland,14.3 - Political,0,0,0,0,0
Nagaland,14.4 - Caste Conflict,0,2,0,0,2
Nagaland,14.4.1 - SC/STs Vs. Non-SCs/STs,0,0,0,0,0
Nagaland,14.4.2 - Other Caste Riots,0,2,0,0,2
Nagaland,14.5 - Agrarian,0,0,0,0,0
Nagaland,14.6 - Students,0,0,0,0,0
Nagaland,14.7 - Sectarian,0,0,0,0,0
Nagaland,14.8 - Other Riots,1,1,0,0,2
Nagaland,15 - Criminal Breach of Trust (Section 406 to 409 IPC),6,4,2,0,12
Nagaland,16 - Cheating (Section 420 IPC),28,14,4,0,46
Nagaland,"17 - Forgery (Section 465, 468 & 471 IPC)",9,4,0,0,13
Nagaland,"18 - Counterfeiting (Section 231-235,237-240, 242-243, 255 and 489-A to 489-E IPC)",2,3,2,0,7
Nagaland,"18.1 - Offences related to Counterfeit Coin (Section 231-235,237, 238-240 & 242-243 IPC)",0,1,0,0,1
Nagaland,18.2 - Counterfeiting Government Stamp (Section 255 IPC),0,0,0,0,0
Nagaland,18.3 - Counterfeit currency & Bank notes (Section 489-A to 489-E IPC),2,2,2,0,6
Nagaland,18.3.1 - Counterfeiting currency notes or Bank notes (Section 489A IPC),0,0,0,0,0
Nagaland,18.3.2 - Using forged or counterfeit currency/Bank notes (Section 489B IPC),1,0,0,0,1
Nagaland,18.3.3 - Possession of forged or counterfeiting currency / Bank notes (Section 489C IPC),1,1,1,0,3
Nagaland,18.3.4 - Make/Possess materials for forging or counterfeiting currency/Bank notes (Section 489D IPC),0,1,1,0,2
Nagaland,18.3.5 - Make/Use documents resembling currency notes/Bank notes (Section 489 E IPC),0,0,0,0,0
Nagaland,19 - Arson (Section 435-436 & 438 IPC),5,2,0,0,7
Nagaland,"20 - Grievous Hurt (Section 325,326,326A & 326 B IPC)",16,6,3,0,25
Nagaland,20.1 - Grievous Hurt (Section 325 & 326 IPC),16,6,3,0,25
Nagaland,20.2 - Acid attack (Section 326A IPC),0,0,0,0,0
Nagaland,20.3 - Attempt to Acid Attack (Section 326B IPC),0,0,0,0,0
Nagaland,21 - Dowry Deaths (Section 304-B IPC),0,0,0,0,0
Nagaland,22 - Assault on women with intent to outrage her Modesty (Section 354 IPC),6,5,2,0,13
Nagaland,22.1 - Sexual Harassment (Section 354A IPC),3,1,0,0,4
Nagaland,22.2 - Assault on women with intent to Disrobe (Section 354B IPC),1,2,1,0,4
Nagaland,22.3 - Voyeurism (Section 354C IPC),0,0,0,0,0
Nagaland,22.4 - Stalking (Section 354D IPC),1,0,0,0,1
Nagaland,22.5 - Others,1,2,1,0,4
Nagaland,23 - Insult to the Modesty of Women (Section 509 IPC),0,0,1,0,1
Nagaland,23.1 - At Office premises,0,0,0,0,0
Nagaland,23.2 - Places related to work other than Office,0,0,0,0,0
Nagaland,23.3 - In Public Transport system,0,0,0,0,0
Nagaland,23.4 - in Other Places,0,0,1,0,1
Nagaland,24 - Cruelty by Husband or his Relatives (Section 498-A IPC),1,1,1,0,3
Nagaland,25 - Importation of Girls from Foreign Country (Section 366-B IPC),0,0,0,0,0
Nagaland,26 - Causing Death by Negligence (Section 304-A IPC),13,2,0,0,15
Nagaland,26.1 - Deaths due to negligent driving/act,11,1,0,0,12
Nagaland,26.2 - Deaths due to Other Causes,2,1,0,0,3
Nagaland,"27 - Offences against State (Section 121, 121A, 122, 123, 124-A IPC)",0,0,0,0,0
Nagaland,27.1 - Sedition (Section 124A IPC),0,0,0,0,0
Nagaland,27.2 - Other offences against State,0,0,0,0,0
Nagaland,28 - Offences promoting enmity between different groups (Section 153A & 153B IPC),0,0,0,0,0
Nagaland,28.1 - Promoting enmity on ground of religion race and place of Birth (Section 153A IPC),0,0,0,0,0
Nagaland,28.2 - Imputation & assertions prejudicial to national integration (Section 153B IPC),0,0,0,0,0
Nagaland,29 - Extortion (Section 384 - 389 IPC),70,48,8,2,128
Nagaland,30 - Disclosure of Identity of Victims (Section 228 A IPC),0,0,0,0,0
Nagaland,31 - Incidence of Rash Driving (Section 279 IPC Read with 337 & 338),0,2,0,0,2
Nagaland,32 - Human Trafficking (Section 370 & 370A IPC),2,0,1,0,3
Nagaland,33 - Unnatural Offences U/s 377 IPC,0,0,0,0,0
Nagaland,34 - Other IPC crimes,77,76,18,0,171
Nagaland,35 - Total Cognizable IPC crimes,584,456,85,6,1131
Odisha,1 - Murder (Section 302 IPC),866,964,443,9,2282
Odisha,2 - Attempt to commit Murder (Section 307 IPC),1428,1419,912,75,3834
Odisha,3 - Culpable Homicide not amounting to Murder (Section 304 IPC),41,16,8,0,65
Odisha,4 - Attempt to commit Culpable Homicide (Section 308 IPC),1,0,0,0,1
Odisha,5 - Rape (Section 376 IPC),1306,658,139,2,2105
Odisha,5.1 - Custodial Rape,0,0,0,0,0
Odisha,5.1.1 - Gang Rape,0,0,0,0,0
Odisha,5.1.2 - Other Rape,0,0,0,0,0
Odisha,5.2 - Rape other than Custodial,1306,658,139,2,2105
Odisha,5.2.1 - Gang Rape,86,54,0,0,140
Odisha,5.2.2 - Other Rape,1220,604,139,2,1965
Odisha,6 - Attempt to commit Rape (Section 376/511 IPC),13,9,2,0,24
Odisha,"7 - Kidnapping & Abduction_Total (Section 3,364,364A, 366-369 IPC)",1367,893,200,6,2466
Odisha,7.1 - Kidnapping & Abduction (Section 363 IPC),313,210,60,2,585
Odisha,7.2 - Kidnaping & Abduction in order to Murder (Section 364 IPC),2,0,0,0,2
Odisha,7.3 - Kidnapping for Ransom (Section 364A IPC),1,7,3,0,11
Odisha,7.4 - Kidnapping & Abduction of Women to compel her for marriage (Section 366 IPC),654,441,79,4,1178
Odisha,7.5 - Other Kidnapping,397,235,58,0,690
Odisha,"8 - Dacoity (Section 395,396-398 IPC)",954,660,367,5,1986
Odisha,8.1 - Dacoity with Murder (Section 396 IPC),0,0,0,0,0
Odisha,8.2 - Other Dacoity,954,660,367,5,1986
Odisha,9 - Making Preparation and Assembly for committing Dacoity (Section 399 & 402 IPC),327,161,63,0,551
Odisha,"10 - Robbery (Section 392 to 394, 397 and 398 IPC)",1458,929,235,7,2629
Odisha,11 - Criminal Trespass/Burglary_Total (Section 453 to 460 IPC),1822,1451,538,21,3832
Odisha,"11.1 - Criminal Trespass/Burglary (Section 455, 457 & 458 IPC)",1547,1192,392,21,3152
Odisha,"11.2 - House Trespass & House Breaking (Section 453,454,456,459 & 460 IPC)",275,259,146,0,680
Odisha,12 - Theft (Section 379 to 382 IPC),3929,2886,1109,52,7976
Odisha,12.1 - Auto Theft,1220,725,258,0,2203
Odisha,12.2 - Other Thefts,2709,2161,851,52,5773
Odisha,"13 - Unlawful Assembly (Section 143,144 & 145)",151,162,77,2,392
Odisha,"14 - Riots (Section 147, 148, 149, 150 & 151 IPC)",5249,4831,1461,13,11554
Odisha,14.1 - Communal,4,3,1,0,8
Odisha,14.2 - Industrial,121,67,8,0,196
Odisha,14.3 - Political,91,90,25,0,206
Odisha,14.4 - Caste Conflict,397,319,113,2,831
Odisha,14.4.1 - SC/STs Vs. Non-SCs/STs,8,5,0,0,13
Odisha,14.4.2 - Other Caste Riots,389,314,113,2,818
Odisha,14.5 - Agrarian,50,12,1,0,63
Odisha,14.6 - Students,24,0,0,0,24
Odisha,14.7 - Sectarian,6,4,0,0,10
Odisha,14.8 - Other Riots,4556,4336,1313,11,10216
Odisha,15 - Criminal Breach of Trust (Section 406 to 409 IPC),252,285,141,2,680
Odisha,16 - Cheating (Section 420 IPC),635,1068,666,7,2376
Odisha,"17 - Forgery (Section 465, 468 & 471 IPC)",0,9,12,0,21
Odisha,"18 - Counterfeiting (Section 231-235,237-240, 242-243, 255 and 489-A to 489-E IPC)",17,9,0,0,26
Odisha,"18.1 - Offences related to Counterfeit Coin (Section 231-235,237, 238-240 & 242-243 IPC)",0,0,0,0,0
Odisha,18.2 - Counterfeiting Government Stamp (Section 255 IPC),0,0,0,0,0
Odisha,18.3 - Counterfeit currency & Bank notes (Section 489-A to 489-E IPC),17,9,0,0,26
Odisha,18.3.1 - Counterfeiting currency notes or Bank notes (Section 489A IPC),8,5,0,0,13
Odisha,18.3.2 - Using forged or counterfeit currency/Bank notes (Section 489B IPC),6,0,0,0,6
Odisha,18.3.3 - Possession of forged or counterfeiting currency / Bank notes (Section 489C IPC),3,4,0,0,7
Odisha,18.3.4 - Make/Possess materials for forging or counterfeiting currency/Bank notes (Section 489D IPC),0,0,0,0,0
Odisha,18.3.5 - Make/Use documents resembling currency notes/Bank notes (Section 489 E IPC),0,0,0,0,0
Odisha,19 - Arson (Section 435-436 & 438 IPC),244,256,76,0,576
Odisha,"20 - Grievous Hurt (Section 325,326,326A & 326 B IPC)",2923,3402,2256,329,8910
Odisha,20.1 - Grievous Hurt (Section 325 & 326 IPC),2918,3400,2256,329,8903
Odisha,20.2 - Acid attack (Section 326A IPC),5,2,0,0,7
Odisha,20.3 - Attempt to Acid Attack (Section 326B IPC),0,0,0,0,0
Odisha,21 - Dowry Deaths (Section 304-B IPC),558,515,210,43,1326
Odisha,22 - Assault on women with intent to outrage her Modesty (Section 354 IPC),3326,2514,823,11,6674
Odisha,22.1 - Sexual Harassment (Section 354A IPC),520,390,90,4,1004
Odisha,22.2 - Assault on women with intent to Disrobe (Section 354B IPC),505,495,134,6,1140
Odisha,22.3 - Voyeurism (Section 354C IPC),17,6,0,0,23
Odisha,22.4 - Stalking (Section 354D IPC),73,51,1,0,125
Odisha,22.5 - Others,2211,1572,598,1,4382
Odisha,23 - Insult to the Modesty of Women (Section 509 IPC),319,133,11,0,463
Odisha,23.1 - At Office premises,6,0,0,0,6
Odisha,23.2 - Places related to work other than Office,2,6,2,0,10
Odisha,23.3 - In Public Transport system,4,4,0,0,8
Odisha,23.4 - in Other Places,307,123,9,0,439
Odisha,24 - Cruelty by Husband or his Relatives (Section 498-A IPC),2437,2799,1166,119,6521
Odisha,25 - Importation of Girls from Foreign Country (Section 366-B IPC),0,0,0,0,0
Odisha,26 - Causing Death by Negligence (Section 304-A IPC),2343,1606,575,3,4527
Odisha,26.1 - Deaths due to negligent driving/act,2334,1577,572,3,4486
Odisha,26.2 - Deaths due to Other Causes,9,29,3,0,41
Odisha,"27 - Offences against State (Section 121, 121A, 122, 123, 124-A IPC)",4,0,1,0,5
Odisha,27.1 - Sedition (Section 124A IPC),3,0,1,0,4
Odisha,27.2 - Other offences against State,1,0,0,0,1
Odisha,28 - Offences promoting enmity between different groups (Section 153A & 153B IPC),15,0,0,0,15
Odisha,28.1 - Promoting enmity on ground of religion race and place of Birth (Section 153A IPC),15,0,0,0,15
Odisha,28.2 - Imputation & assertions prejudicial to national integration (Section 153B IPC),0,0,0,0,0
Odisha,29 - Extortion (Section 384 - 389 IPC),241,185,18,0,444
Odisha,30 - Disclosure of Identity of Victims (Section 228 A IPC),0,0,0,0,0
Odisha,31 - Incidence of Rash Driving (Section 279 IPC Read with 337 & 338),1890,1175,463,2,3530
Odisha,32 - Human Trafficking (Section 370 & 370A IPC),7,28,10,0,45
Odisha,33 - Unnatural Offences U/s 377 IPC,9,7,2,0,18
Odisha,34 - Other IPC crimes,12650,11631,5425,303,30009
Odisha,35 - Total Cognizable IPC crimes,46782,40661,17409,1011,105863
Punjab,1 - Murder (Section 302 IPC),446,621,277,13,1357
Punjab,2 - Attempt to commit Murder (Section 307 IPC),709,895,429,14,2047
Punjab,3 - Culpable Homicide not amounting to Murder (Section 304 IPC),44,82,11,0,137
Punjab,4 - Attempt to commit Culpable Homicide (Section 308 IPC),14,50,11,0,75
Punjab,5 - Rape (Section 376 IPC),594,504,96,3,1197
Punjab,5.1 - Custodial Rape,0,0,0,0,0
Punjab,5.1.1 - Gang Rape,0,0,0,0,0
Punjab,5.1.2 - Other Rape,0,0,0,0,0
Punjab,5.2 - Rape other than Custodial,594,504,96,3,1197
Punjab,5.2.1 - Gang Rape,27,18,0,0,45
Punjab,5.2.2 - Other Rape,567,486,96,3,1152
Punjab,6 - Attempt to commit Rape (Section 376/511 IPC),90,46,3,1,140
Punjab,"7 - Kidnapping & Abduction_Total (Section 3,364,364A, 366-369 IPC)",740,367,86,4,1197
Punjab,7.1 - Kidnapping & Abduction (Section 363 IPC),39,32,2,0,73
Punjab,7.2 - Kidnaping & Abduction in order to Murder (Section 364 IPC),12,13,17,2,44
Punjab,7.3 - Kidnapping for Ransom (Section 364A IPC),0,6,0,0,6
Punjab,7.4 - Kidnapping & Abduction of Women to compel her for marriage (Section 366 IPC),398,205,50,2,655
Punjab,7.5 - Other Kidnapping,291,111,17,0,419
Punjab,"8 - Dacoity (Section 395,396-398 IPC)",68,74,10,0,152
Punjab,8.1 - Dacoity with Murder (Section 396 IPC),2,3,0,0,5
Punjab,8.2 - Other Dacoity,66,71,10,0,147
Punjab,9 - Making Preparation and Assembly for committing Dacoity (Section 399 & 402 IPC),404,260,19,0,683
Punjab,"10 - Robbery (Section 392 to 394, 397 and 398 IPC)",183,108,3,0,294
Punjab,11 - Criminal Trespass/Burglary_Total (Section 453 to 460 IPC),1207,885,228,1,2321
Punjab,"11.1 - Criminal Trespass/Burglary (Section 455, 457 & 458 IPC)",715,592,165,0,1472
Punjab,"11.2 - House Trespass & House Breaking (Section 453,454,456,459 & 460 IPC)",492,293,63,1,849
Punjab,12 - Theft (Section 379 to 382 IPC),2326,1725,497,3,4551
Punjab,12.1 - Auto Theft,753,568,132,1,1454
Punjab,12.2 - Other Thefts,1573,1157,365,2,3097
Punjab,"13 - Unlawful Assembly (Section 143,144 & 145)",0,0,0,0,0
Punjab,"14 - Riots (Section 147, 148, 149, 150 & 151 IPC)",0,0,0,0,0
Punjab,14.1 - Communal,0,0,0,0,0
Punjab,14.2 - Industrial,0,0,0,0,0
Punjab,14.3 - Political,0,0,0,0,0
Punjab,14.4 - Caste Conflict,0,0,0,0,0
Punjab,14.4.1 - SC/STs Vs. Non-SCs/STs,0,0,0,0,0
Punjab,14.4.2 - Other Caste Riots,0,0,0,0,0
Punjab,14.5 - Agrarian,0,0,0,0,0
Punjab,14.6 - Students,0,0,0,0,0
Punjab,14.7 - Sectarian,0,0,0,0,0
Punjab,14.8 - Other Riots,0,0,0,0,0
Punjab,15 - Criminal Breach of Trust (Section 406 to 409 IPC),72,174,69,4,319
Punjab,16 - Cheating (Section 420 IPC),1338,2751,1125,43,5257
Punjab,"17 - Forgery (Section 465, 468 & 471 IPC)",10,38,14,1,63
Punjab,"18 - Counterfeiting (Section 231-235,237-240, 242-243, 255 and 489-A to 489-E IPC)",12,31,4,0,47
Punjab,"18.1 - Offences related to Counterfeit Coin (Section 231-235,237, 238-240 & 242-243 IPC)",0,0,0,0,0
Punjab,18.2 - Counterfeiting Government Stamp (Section 255 IPC),0,0,0,0,0
Punjab,18.3 - Counterfeit currency & Bank notes (Section 489-A to 489-E IPC),12,31,4,0,47
Punjab,18.3.1 - Counterfeiting currency notes or Bank notes (Section 489A IPC),9,22,0,0,31
Punjab,18.3.2 - Using forged or counterfeit currency/Bank notes (Section 489B IPC),0,1,1,0,2
Punjab,18.3.3 - Possession of forged or counterfeiting currency / Bank notes (Section 489C IPC),0,2,1,0,3
Punjab,18.3.4 - Make/Possess materials for forging or counterfeiting currency/Bank notes (Section 489D IPC),0,0,0,0,0
Punjab,18.3.5 - Make/Use documents resembling currency notes/Bank notes (Section 489 E IPC),3,6,2,0,11
Punjab,19 - Arson (Section 435-436 & 438 IPC),27,56,11,0,94
Punjab,"20 - Grievous Hurt (Section 325,326,326A & 326 B IPC)",2261,2560,1079,17,5917
Punjab,20.1 - Grievous Hurt (Section 325 & 326 IPC),2253,2555,1079,17,5904
Punjab,20.2 - Acid attack (Section 326A IPC),6,5,0,0,11
Punjab,20.3 - Attempt to Acid Attack (Section 326B IPC),2,0,0,0,2
Punjab,21 - Dowry Deaths (Section 304-B IPC),56,97,33,0,186
Punjab,22 - Assault on women with intent to outrage her Modesty (Section 354 IPC),788,445,27,0,1260
Punjab,22.1 - Sexual Harassment (Section 354A IPC),247,111,5,0,363
Punjab,22.2 - Assault on women with intent to Disrobe (Section 354B IPC),44,15,1,0,60
Punjab,22.3 - Voyeurism (Section 354C IPC),49,34,5,0,88
Punjab,22.4 - Stalking (Section 354D IPC),39,15,0,0,54
Punjab,22.5 - Others,409,270,16,0,695
Punjab,23 - Insult to the Modesty of Women (Section 509 IPC),21,22,0,0,43
Punjab,23.1 - At Office premises,0,0,0,0,0
Punjab,23.2 - Places related to work other than Office,1,2,0,0,3
Punjab,23.3 - In Public Transport system,0,0,0,0,0
Punjab,23.4 - in Other Places,20,20,0,0,40
Punjab,24 - Cruelty by Husband or his Relatives (Section 498-A IPC),984,1132,587,17,2720
Punjab,25 - Importation of Girls from Foreign Country (Section 366-B IPC),0,0,0,0,0
Punjab,26 - Causing Death by Negligence (Section 304-A IPC),938,1075,390,22,2425
Punjab,26.1 - Deaths due to negligent driving/act,924,1058,390,22,2394
Punjab,26.2 - Deaths due to Other Causes,14,17,0,0,31
Punjab,"27 - Offences against State (Section 121, 121A, 122, 123, 124-A IPC)",0,0,0,0,0
Punjab,27.1 - Sedition (Section 124A IPC),0,0,0,0,0
Punjab,27.2 - Other offences against State,0,0,0,0,0
Punjab,28 - Offences promoting enmity between different groups (Section 153A & 153B IPC),0,0,0,0,0
Punjab,28.1 - Promoting enmity on ground of religion race and place of Birth (Section 153A IPC),0,0,0,0,0
Punjab,28.2 - Imputation & assertions prejudicial to national integration (Section 153B IPC),0,0,0,0,0
Punjab,29 - Extortion (Section 384 - 389 IPC),15,26,0,0,41
Punjab,30 - Disclosure of Identity of Victims (Section 228 A IPC),0,0,0,0,0
Punjab,31 - Incidence of Rash Driving (Section 279 IPC Read with 337 & 338),581,542,228,7,1358
Punjab,32 - Human Trafficking (Section 370 & 370A IPC),0,0,1,0,1
Punjab,33 - Unnatural Offences U/s 377 IPC,54,17,0,0,71
Punjab,34 - Other IPC crimes,4616,5515,2188,34,12353
Punjab,35 - Total Cognizable IPC crimes,18598,20098,7426,184,46306
Rajasthan,1 - Murder (Section 302 IPC),834,869,430,32,2165
Rajasthan,2 - Attempt to commit Murder (Section 307 IPC),1922,1684,857,76,4539
Rajasthan,3 - Culpable Homicide not amounting to Murder (Section 304 IPC),28,44,15,0,87
Rajasthan,4 - Attempt to commit Culpable Homicide (Section 308 IPC),164,166,85,0,415
Rajasthan,5 - Rape (Section 376 IPC),1556,829,291,2,2678
Rajasthan,5.1 - Custodial Rape,0,0,0,0,0
Rajasthan,5.1.1 - Gang Rape,0,0,0,0,0
Rajasthan,5.1.2 - Other Rape,0,0,0,0,0
Rajasthan,5.2 - Rape other than Custodial,1556,829,291,2,2678
Rajasthan,5.2.1 - Gang Rape,222,119,17,0,358
Rajasthan,5.2.2 - Other Rape,1334,710,274,2,2320
Rajasthan,6 - Attempt to commit Rape (Section 376/511 IPC),163,94,25,1,283
Rajasthan,"7 - Kidnapping & Abduction_Total (Section 3,364,364A, 366-369 IPC)",1531,933,300,5,2769
Rajasthan,7.1 - Kidnapping & Abduction (Section 363 IPC),294,145,29,1,469
Rajasthan,7.2 - Kidnaping & Abduction in order to Murder (Section 364 IPC),23,11,4,0,38
Rajasthan,7.3 - Kidnapping for Ransom (Section 364A IPC),24,29,3,0,56
Rajasthan,7.4 - Kidnapping & Abduction of Women to compel her for marriage (Section 366 IPC),582,348,98,2,1030
Rajasthan,7.5 - Other Kidnapping,608,400,166,2,1176
Rajasthan,"8 - Dacoity (Section 395,396-398 IPC)",173,78,12,0,263
Rajasthan,8.1 - Dacoity with Murder (Section 396 IPC),5,0,0,0,5
Rajasthan,8.2 - Other Dacoity,168,78,12,0,258
Rajasthan,9 - Making Preparation and Assembly for committing Dacoity (Section 399 & 402 IPC),316,167,25,0,508
Rajasthan,"10 - Robbery (Section 392 to 394, 397 and 398 IPC)",1134,531,194,3,1862
Rajasthan,11 - Criminal Trespass/Burglary_Total (Section 453 to 460 IPC),1569,1021,504,10,3104
Rajasthan,"11.1 - Criminal Trespass/Burglary (Section 455, 457 & 458 IPC)",1114,684,351,6,2155
Rajasthan,"11.2 - House Trespass & House Breaking (Section 453,454,456,459 & 460 IPC)",455,337,153,4,949
Rajasthan,12 - Theft (Section 379 to 382 IPC),5260,2839,1030,23,9152
Rajasthan,12.1 - Auto Theft,2163,1032,256,1,3452
Rajasthan,12.2 - Other Thefts,3097,1807,774,22,5700
Rajasthan,"13 - Unlawful Assembly (Section 143,144 & 145)",5796,4625,2159,229,12809
Rajasthan,"14 - Riots (Section 147, 148, 149, 150 & 151 IPC)",859,1116,422,65,2462
Rajasthan,14.1 - Communal,18,19,2,0,39
Rajasthan,14.2 - Industrial,4,12,0,0,16
Rajasthan,14.3 - Political,0,0,0,0,0
Rajasthan,14.4 - Caste Conflict,0,0,0,0,0
Rajasthan,14.4.1 - SC/STs Vs. Non-SCs/STs,0,0,0,0,0
Rajasthan,14.4.2 - Other Caste Riots,0,0,0,0,0
Rajasthan,14.5 - Agrarian,76,86,16,3,181
Rajasthan,14.6 - Students,0,0,0,0,0
Rajasthan,14.7 - Sectarian,0,0,0,0,0
Rajasthan,14.8 - Other Riots,761,999,404,62,2226
Rajasthan,15 - Criminal Breach of Trust (Section 406 to 409 IPC),69,125,46,6,246
Rajasthan,16 - Cheating (Section 420 IPC),1302,2329,1523,210,5364
Rajasthan,"17 - Forgery (Section 465, 468 & 471 IPC)",369,568,305,30,1272
Rajasthan,"18 - Counterfeiting (Section 231-235,237-240, 242-243, 255 and 489-A to 489-E IPC)",10,39,3,0,52
Rajasthan,"18.1 - Offences related to Counterfeit Coin (Section 231-235,237, 238-240 & 242-243 IPC)",1,4,0,0,5
Rajasthan,18.2 - Counterfeiting Government Stamp (Section 255 IPC),0,0,0,0,0
Rajasthan,18.3 - Counterfeit currency & Bank notes (Section 489-A to 489-E IPC),9,35,3,0,47
Rajasthan,18.3.1 - Counterfeiting currency notes or Bank notes (Section 489A IPC),3,24,0,0,27
Rajasthan,18.3.2 - Using forged or counterfeit currency/Bank notes (Section 489B IPC),5,10,2,0,17
Rajasthan,18.3.3 - Possession of forged or counterfeiting currency / Bank notes (Section 489C IPC),1,1,1,0,3
Rajasthan,18.3.4 - Make/Possess materials for forging or counterfeiting currency/Bank notes (Section 489D IPC),0,0,0,0,0
Rajasthan,18.3.5 - Make/Use documents resembling currency notes/Bank notes (Section 489 E IPC),0,0,0,0,0
Rajasthan,19 - Arson (Section 435-436 & 438 IPC),201,208,84,8,501
Rajasthan,"20 - Grievous Hurt (Section 325,326,326A & 326 B IPC)",2689,1835,910,89,5523
Rajasthan,20.1 - Grievous Hurt (Section 325 & 326 IPC),2679,1832,910,89,5510
Rajasthan,20.2 - Acid attack (Section 326A IPC),10,3,0,0,13
Rajasthan,20.3 - Attempt to Acid Attack (Section 326B IPC),0,0,0,0,0
Rajasthan,21 - Dowry Deaths (Section 304-B IPC),188,194,132,14,528
Rajasthan,22 - Assault on women with intent to outrage her Modesty (Section 354 IPC),2953,1799,994,32,5778
Rajasthan,22.1 - Sexual Harassment (Section 354A IPC),196,165,460,2,823
Rajasthan,22.2 - Assault on women with intent to Disrobe (Section 354B IPC),112,58,68,0,238
Rajasthan,22.3 - Voyeurism (Section 354C IPC),17,4,5,0,26
Rajasthan,22.4 - Stalking (Section 354D IPC),54,15,5,0,74
Rajasthan,22.5 - Others,2574,1557,456,30,4617
Rajasthan,23 - Insult to the Modesty of Women (Section 509 IPC),8,3,1,0,12
Rajasthan,23.1 - At Office premises,0,0,0,0,0
Rajasthan,23.2 - Places related to work other than Office,0,0,0,0,0
Rajasthan,23.3 - In Public Transport system,0,1,0,0,1
Rajasthan,23.4 - in Other Places,8,2,1,0,11
Rajasthan,24 - Cruelty by Husband or his Relatives (Section 498-A IPC),4863,3763,2560,374,11560
Rajasthan,25 - Importation of Girls from Foreign Country (Section 366-B IPC),0,0,0,0,0
Rajasthan,26 - Causing Death by Negligence (Section 304-A IPC),2844,3403,1436,68,7751
Rajasthan,26.1 - Deaths due to negligent driving/act,2833,3372,1420,68,7693
Rajasthan,26.2 - Deaths due to Other Causes,11,31,16,0,58
Rajasthan,"27 - Offences against State (Section 121, 121A, 122, 123, 124-A IPC)",0,0,0,0,0
Rajasthan,27.1 - Sedition (Section 124A IPC),0,0,0,0,0
Rajasthan,27.2 - Other offences against State,0,0,0,0,0
Rajasthan,28 - Offences promoting enmity between different groups (Section 153A & 153B IPC),6,18,5,0,29
Rajasthan,28.1 - Promoting enmity on ground of religion race and place of Birth (Section 153A IPC),6,18,5,0,29
Rajasthan,28.2 - Imputation & assertions prejudicial to national integration (Section 153B IPC),0,0,0,0,0
Rajasthan,29 - Extortion (Section 384 - 389 IPC),145,163,75,1,384
Rajasthan,30 - Disclosure of Identity of Victims (Section 228 A IPC),0,0,0,0,0
Rajasthan,31 - Incidence of Rash Driving (Section 279 IPC Read with 337 & 338),5649,5167,1850,134,12800
Rajasthan,32 - Human Trafficking (Section 370 & 370A IPC),6,9,1,0,16
Rajasthan,33 - Unnatural Offences U/s 377 IPC,19,12,4,0,35
Rajasthan,34 - Other IPC crimes,42133,38050,27068,2532,109783
Rajasthan,35 - Total Cognizable IPC crimes,84759,72681,43346,3944,204730
Sikkim,1 - Murder (Section 302 IPC),15,7,4,0,26
Sikkim,2 - Attempt to commit Murder (Section 307 IPC),9,6,0,0,15
Sikkim,3 - Culpable Homicide not amounting to Murder (Section 304 IPC),2,1,0,1,4
Sikkim,4 - Attempt to commit Culpable Homicide (Section 308 IPC),0,0,0,0,0
Sikkim,5 - Rape (Section 376 IPC),81,14,7,2,104
Sikkim,5.1 - Custodial Rape,0,0,0,0,0
Sikkim,5.1.1 - Gang Rape,0,0,0,0,0
Sikkim,5.1.2 - Other Rape,0,0,0,0,0
Sikkim,5.2 - Rape other than Custodial,81,14,7,2,104
Sikkim,5.2.1 - Gang Rape,2,0,0,0,2
Sikkim,5.2.2 - Other Rape,79,14,7,2,102
Sikkim,6 - Attempt to commit Rape (Section 376/511 IPC),4,4,2,0,10
Sikkim,"7 - Kidnapping & Abduction_Total (Section 3,364,364A, 366-369 IPC)",21,15,0,0,36
Sikkim,7.1 - Kidnapping & Abduction (Section 363 IPC),7,6,0,0,13
Sikkim,7.2 - Kidnaping & Abduction in order to Murder (Section 364 IPC),0,0,0,0,0
Sikkim,7.3 - Kidnapping for Ransom (Section 364A IPC),0,0,0,0,0
Sikkim,7.4 - Kidnapping & Abduction of Women to compel her for marriage (Section 366 IPC),0,0,0,0,0
Sikkim,7.5 - Other Kidnapping,14,9,0,0,23
Sikkim,"8 - Dacoity (Section 395,396-398 IPC)",5,1,0,0,6
Sikkim,8.1 - Dacoity with Murder (Section 396 IPC),0,0,0,0,0
Sikkim,8.2 - Other Dacoity,5,1,0,0,6
Sikkim,9 - Making Preparation and Assembly for committing Dacoity (Section 399 & 402 IPC),0,0,0,0,0
Sikkim,"10 - Robbery (Section 392 to 394, 397 and 398 IPC)",9,15,0,0,24
Sikkim,11 - Criminal Trespass/Burglary_Total (Section 453 to 460 IPC),83,31,1,0,115
Sikkim,"11.1 - Criminal Trespass/Burglary (Section 455, 457 & 458 IPC)",58,22,1,0,81
Sikkim,"11.2 - House Trespass & House Breaking (Section 453,454,456,459 & 460 IPC)",25,9,0,0,34
Sikkim,12 - Theft (Section 379 to 382 IPC),89,50,1,0,140
Sikkim,12.1 - Auto Theft,9,4,0,0,13
Sikkim,12.2 - Other Thefts,80,46,1,0,127
Sikkim,"13 - Unlawful Assembly (Section 143,144 & 145)",11,6,0,0,17
Sikkim,"14 - Riots (Section 147, 148, 149, 150 & 151 IPC)",393,288,60,6,747
Sikkim,14.1 - Communal,3,0,0,0,3
Sikkim,14.2 - Industrial,0,0,0,0,0
Sikkim,14.3 - Political,286,280,57,6,629
Sikkim,14.4 - Caste Conflict,11,4,3,0,18
Sikkim,14.4.1 - SC/STs Vs. Non-SCs/STs,0,0,0,0,0
Sikkim,14.4.2 - Other Caste Riots,11,4,3,0,18
Sikkim,14.5 - Agrarian,0,0,0,0,0
Sikkim,14.6 - Students,74,0,0,0,74
Sikkim,14.7 - Sectarian,0,0,0,0,0
Sikkim,14.8 - Other Riots,19,4,0,0,23
Sikkim,15 - Criminal Breach of Trust (Section 406 to 409 IPC),6,8,0,0,14
Sikkim,16 - Cheating (Section 420 IPC),29,38,1,0,68
Sikkim,"17 - Forgery (Section 465, 468 & 471 IPC)",5,2,0,0,7
Sikkim,"18 - Counterfeiting (Section 231-235,237-240, 242-243, 255 and 489-A to 489-E IPC)",1,3,1,0,5
Sikkim,"18.1 - Offences related to Counterfeit Coin (Section 231-235,237, 238-240 & 242-243 IPC)",0,0,0,0,0
Sikkim,18.2 - Counterfeiting Government Stamp (Section 255 IPC),0,0,0,0,0
Sikkim,18.3 - Counterfeit currency & Bank notes (Section 489-A to 489-E IPC),1,3,1,0,5
Sikkim,18.3.1 - Counterfeiting currency notes or Bank notes (Section 489A IPC),0,0,0,0,0
Sikkim,18.3.2 - Using forged or counterfeit currency/Bank notes (Section 489B IPC),1,3,1,0,5
Sikkim,18.3.3 - Possession of forged or counterfeiting currency / Bank notes (Section 489C IPC),0,0,0,0,0
Sikkim,18.3.4 - Make/Possess materials for forging or counterfeiting currency/Bank notes (Section 489D IPC),0,0,0,0,0
Sikkim,18.3.5 - Make/Use documents resembling currency notes/Bank notes (Section 489 E IPC),0,0,0,0,0
Sikkim,19 - Arson (Section 435-436 & 438 IPC),3,6,0,0,9
Sikkim,"20 - Grievous Hurt (Section 325,326,326A & 326 B IPC)",46,32,2,0,80
Sikkim,20.1 - Grievous Hurt (Section 325 & 326 IPC),45,31,2,0,78
Sikkim,20.2 - Acid attack (Section 326A IPC),1,1,0,0,2
Sikkim,20.3 - Attempt to Acid Attack (Section 326B IPC),0,0,0,0,0
Sikkim,21 - Dowry Deaths (Section 304-B IPC),0,0,0,0,0
Sikkim,22 - Assault on women with intent to outrage her Modesty (Section 354 IPC),22,23,5,1,51
Sikkim,22.1 - Sexual Harassment (Section 354A IPC),8,3,4,1,16
Sikkim,22.2 - Assault on women with intent to Disrobe (Section 354B IPC),0,1,0,0,1
Sikkim,22.3 - Voyeurism (Section 354C IPC),0,0,0,0,0
Sikkim,22.4 - Stalking (Section 354D IPC),4,0,0,0,4
Sikkim,22.5 - Others,10,19,1,0,30
Sikkim,23 - Insult to the Modesty of Women (Section 509 IPC),1,2,0,0,3
Sikkim,23.1 - At Office premises,0,0,0,0,0
Sikkim,23.2 - Places related to work other than Office,0,0,0,0,0
Sikkim,23.3 - In Public Transport system,0,0,0,0,0
Sikkim,23.4 - in Other Places,1,2,0,0,3
Sikkim,24 - Cruelty by Husband or his Relatives (Section 498-A IPC),2,3,1,0,6
Sikkim,25 - Importation of Girls from Foreign Country (Section 366-B IPC),0,0,0,0,0
Sikkim,26 - Causing Death by Negligence (Section 304-A IPC),55,27,1,0,83
Sikkim,26.1 - Deaths due to negligent driving/act,54,26,0,0,80
Sikkim,26.2 - Deaths due to Other Causes,1,1,1,0,3
Sikkim,"27 - Offences against State (Section 121, 121A, 122, 123, 124-A IPC)",0,0,0,0,0
Sikkim,27.1 - Sedition (Section 124A IPC),0,0,0,0,0
Sikkim,27.2 - Other offences against State,0,0,0,0,0
Sikkim,28 - Offences promoting enmity between different groups (Section 153A & 153B IPC),0,0,0,0,0
Sikkim,28.1 - Promoting enmity on ground of religion race and place of Birth (Section 153A IPC),0,0,0,0,0
Sikkim,28.2 - Imputation & assertions prejudicial to national integration (Section 153B IPC),0,0,0,0,0
Sikkim,29 - Extortion (Section 384 - 389 IPC),3,1,0,0,4
Sikkim,30 - Disclosure of Identity of Victims (Section 228 A IPC),0,0,0,0,0
Sikkim,31 - Incidence of Rash Driving (Section 279 IPC Read with 337 & 338),98,62,4,1,165
Sikkim,32 - Human Trafficking (Section 370 & 370A IPC),0,0,0,0,0
Sikkim,33 - Unnatural Offences U/s 377 IPC,0,1,0,0,1
Sikkim,34 - Other IPC crimes,124,160,17,0,301
Sikkim,35 - Total Cognizable IPC crimes,1117,806,107,11,2041
Tamil Nadu,1 - Murder (Section 302 IPC),1590,1890,658,66,4204
Tamil Nadu,2 - Attempt to commit Murder (Section 307 IPC),2264,2605,1310,112,6291
Tamil Nadu,3 - Culpable Homicide not amounting to Murder (Section 304 IPC),6,47,12,1,66
Tamil Nadu,4 - Attempt to commit Culpable Homicide (Section 308 IPC),0,0,0,0,0
Tamil Nadu,5 - Rape (Section 376 IPC),432,258,62,0,752
Tamil Nadu,5.1 - Custodial Rape,0,0,0,0,0
Tamil Nadu,5.1.1 - Gang Rape,0,0,0,0,0
Tamil Nadu,5.1.2 - Other Rape,0,0,0,0,0
Tamil Nadu,5.2 - Rape other than Custodial,432,258,62,0,752
Tamil Nadu,5.2.1 - Gang Rape,6,0,0,0,6
Tamil Nadu,5.2.2 - Other Rape,426,258,62,0,746
Tamil Nadu,6 - Attempt to commit Rape (Section 376/511 IPC),14,3,1,0,18
Tamil Nadu,"7 - Kidnapping & Abduction_Total (Section 3,364,364A, 366-369 IPC)",971,772,214,2,1959
Tamil Nadu,7.1 - Kidnapping & Abduction (Section 363 IPC),164,161,37,0,362
Tamil Nadu,7.2 - Kidnaping & Abduction in order to Murder (Section 364 IPC),0,0,0,0,0
Tamil Nadu,7.3 - Kidnapping for Ransom (Section 364A IPC),6,9,0,0,15
Tamil Nadu,7.4 - Kidnapping & Abduction of Women to compel her for marriage (Section 366 IPC),565,411,135,2,1113
Tamil Nadu,7.5 - Other Kidnapping,236,191,42,0,469
Tamil Nadu,"8 - Dacoity (Section 395,396-398 IPC)",268,186,24,1,479
Tamil Nadu,8.1 - Dacoity with Murder (Section 396 IPC),0,0,0,0,0
Tamil Nadu,8.2 - Other Dacoity,268,186,24,1,479
Tamil Nadu,9 - Making Preparation and Assembly for committing Dacoity (Section 399 & 402 IPC),157,131,23,0,311
Tamil Nadu,"10 - Robbery (Section 392 to 394, 397 and 398 IPC)",1258,833,239,4,2334
Tamil Nadu,11 - Criminal Trespass/Burglary_Total (Section 453 to 460 IPC),3820,2585,895,37,7337
Tamil Nadu,"11.1 - Criminal Trespass/Burglary (Section 455, 457 & 458 IPC)",2028,1416,557,12,4013
Tamil Nadu,"11.2 - House Trespass & House Breaking (Section 453,454,456,459 & 460 IPC)",1792,1169,338,25,3324
Tamil Nadu,12 - Theft (Section 379 to 382 IPC),10660,6040,1946,56,18702
Tamil Nadu,12.1 - Auto Theft,3744,1963,654,4,6365
Tamil Nadu,12.2 - Other Thefts,6916,4077,1292,52,12337
Tamil Nadu,"13 - Unlawful Assembly (Section 143,144 & 145)",4939,4449,1142,129,10659
Tamil Nadu,"14 - Riots (Section 147, 148, 149, 150 & 151 IPC)",5169,4383,1862,169,11583
Tamil Nadu,14.1 - Communal,201,266,79,0,546
Tamil Nadu,14.2 - Industrial,0,0,0,0,0
Tamil Nadu,14.3 - Political,15,25,15,0,55
Tamil Nadu,14.4 - Caste Conflict,302,372,112,4,790
Tamil Nadu,14.4.1 - SC/STs Vs. Non-SCs/STs,121,100,12,0,233
Tamil Nadu,14.4.2 - Other Caste Riots,181,272,100,4,557
Tamil Nadu,14.5 - Agrarian,0,0,0,0,0
Tamil Nadu,14.6 - Students,66,0,0,0,66
Tamil Nadu,14.7 - Sectarian,18,14,3,0,35
Tamil Nadu,14.8 - Other Riots,4567,3706,1653,165,10091
Tamil Nadu,15 - Criminal Breach of Trust (Section 406 to 409 IPC),62,206,61,3,332
Tamil Nadu,16 - Cheating (Section 420 IPC),1203,2489,1182,91,4965
Tamil Nadu,"17 - Forgery (Section 465, 468 & 471 IPC)",49,103,47,0,199
Tamil Nadu,"18 - Counterfeiting (Section 231-235,237-240, 242-243, 255 and 489-A to 489-E IPC)",64,118,18,2,202
Tamil Nadu,"18.1 - Offences related to Counterfeit Coin (Section 231-235,237, 238-240 & 242-243 IPC)",0,0,0,0,0
Tamil Nadu,18.2 - Counterfeiting Government Stamp (Section 255 IPC),0,0,0,0,0
Tamil Nadu,18.3 - Counterfeit currency & Bank notes (Section 489-A to 489-E IPC),64,118,18,2,202
Tamil Nadu,18.3.1 - Counterfeiting currency notes or Bank notes (Section 489A IPC),9,43,11,1,64
Tamil Nadu,18.3.2 - Using forged or counterfeit currency/Bank notes (Section 489B IPC),53,65,3,0,121
Tamil Nadu,18.3.3 - Possession of forged or counterfeiting currency / Bank notes (Section 489C IPC),2,10,4,1,17
Tamil Nadu,18.3.4 - Make/Possess materials for forging or counterfeiting currency/Bank notes (Section 489D IPC),0,0,0,0,0
Tamil Nadu,18.3.5 - Make/Use documents resembling currency notes/Bank notes (Section 489 E IPC),0,0,0,0,0
Tamil Nadu,19 - Arson (Section 435-436 & 438 IPC),231,440,120,4,795
Tamil Nadu,"20 - Grievous Hurt (Section 325,326,326A & 326 B IPC)",1180,1284,1002,55,3521
Tamil Nadu,20.1 - Grievous Hurt (Section 325 & 326 IPC),1176,1280,1002,54,3512
Tamil Nadu,20.2 - Acid attack (Section 326A IPC),4,4,0,1,9
Tamil Nadu,20.3 - Attempt to Acid Attack (Section 326B IPC),0,0,0,0,0
Tamil Nadu,21 - Dowry Deaths (Section 304-B IPC),117,137,36,2,292
Tamil Nadu,22 - Assault on women with intent to outrage her Modesty (Section 354 IPC),712,544,332,28,1616
Tamil Nadu,22.1 - Sexual Harassment (Section 354A IPC),37,19,2,0,58
Tamil Nadu,22.2 - Assault on women with intent to Disrobe (Section 354B IPC),44,1,30,22,97
Tamil Nadu,22.3 - Voyeurism (Section 354C IPC),1,0,0,0,1
Tamil Nadu,22.4 - Stalking (Section 354D IPC),0,1,0,0,1
Tamil Nadu,22.5 - Others,630,523,300,6,1459
Tamil Nadu,23 - Insult to the Modesty of Women (Section 509 IPC),312,107,0,0,419
Tamil Nadu,23.1 - At Office premises,0,2,0,0,2
Tamil Nadu,23.2 - Places related to work other than Office,253,52,0,0,305
Tamil Nadu,23.3 - In Public Transport system,0,0,0,0,0
Tamil Nadu,23.4 - in Other Places,59,53,0,0,112
Tamil Nadu,24 - Cruelty by Husband or his Relatives (Section 498-A IPC),996,1547,644,103,3290
Tamil Nadu,25 - Importation of Girls from Foreign Country (Section 366-B IPC),0,0,0,0,0
Tamil Nadu,26 - Causing Death by Negligence (Section 304-A IPC),6272,6862,2624,248,16006
Tamil Nadu,26.1 - Deaths due to negligent driving/act,6174,6754,2605,248,15781
Tamil Nadu,26.2 - Deaths due to Other Causes,98,108,19,0,225
Tamil Nadu,"27 - Offences against State (Section 121, 121A, 122, 123, 124-A IPC)",0,0,0,0,0
Tamil Nadu,27.1 - Sedition (Section 124A IPC),0,0,0,0,0
Tamil Nadu,27.2 - Other offences against State,0,0,0,0,0
Tamil Nadu,28 - Offences promoting enmity between different groups (Section 153A & 153B IPC),8,14,4,0,26
Tamil Nadu,28.1 - Promoting enmity on ground of religion race and place of Birth (Section 153A IPC),8,14,4,0,26
Tamil Nadu,28.2 - Imputation & assertions prejudicial to national integration (Section 153B IPC),0,0,0,0,0
Tamil Nadu,29 - Extortion (Section 384 - 389 IPC),331,358,49,0,738
Tamil Nadu,30 - Disclosure of Identity of Victims (Section 228 A IPC),0,1,0,0,1
Tamil Nadu,31 - Incidence of Rash Driving (Section 279 IPC Read with 337 & 338),22254,20085,8427,561,51327
Tamil Nadu,32 - Human Trafficking (Section 370 & 370A IPC),0,0,0,0,0
Tamil Nadu,33 - Unnatural Offences U/s 377 IPC,5,1,0,0,6
Tamil Nadu,34 - Other IPC crimes,41603,45981,21938,2675,112197
Tamil Nadu,35 - Total Cognizable IPC crimes,106947,104459,44872,4349,260627
Telangana,1 - Murder (Section 302 IPC),834,992,476,65,2367
Telangana,2 - Attempt to commit Murder (Section 307 IPC),690,787,424,120,2021
Telangana,3 - Culpable Homicide not amounting to Murder (Section 304 IPC),59,133,80,18,290
Telangana,4 - Attempt to commit Culpable Homicide (Section 308 IPC),1,0,0,0,1
Telangana,5 - Rape (Section 376 IPC),583,383,181,34,1181
Telangana,5.1 - Custodial Rape,0,0,0,0,0
Telangana,5.1.1 - Gang Rape,0,0,0,0,0
Telangana,5.1.2 - Other Rape,0,0,0,0,0
Telangana,5.2 - Rape other than Custodial,583,383,181,34,1181
Telangana,5.2.1 - Gang Rape,15,27,0,0,42
Telangana,5.2.2 - Other Rape,568,356,181,34,1139
Telangana,6 - Attempt to commit Rape (Section 376/511 IPC),23,33,18,0,74
Telangana,"7 - Kidnapping & Abduction_Total (Section 3,364,364A, 366-369 IPC)",811,685,206,30,1732
Telangana,7.1 - Kidnapping & Abduction (Section 363 IPC),169,215,19,1,404
Telangana,7.2 - Kidnaping & Abduction in order to Murder (Section 364 IPC),30,12,3,2,47
Telangana,7.3 - Kidnapping for Ransom (Section 364A IPC),14,7,2,0,23
Telangana,7.4 - Kidnapping & Abduction of Women to compel her for marriage (Section 366 IPC),303,220,119,25,667
Telangana,7.5 - Other Kidnapping,295,231,63,2,591
Telangana,"8 - Dacoity (Section 395,396-398 IPC)",173,169,25,5,372
Telangana,8.1 - Dacoity with Murder (Section 396 IPC),0,6,0,0,6
Telangana,8.2 - Other Dacoity,173,163,25,5,366
Telangana,9 - Making Preparation and Assembly for committing Dacoity (Section 399 & 402 IPC),0,3,0,0,3
Telangana,"10 - Robbery (Section 392 to 394, 397 and 398 IPC)",237,293,154,1,685
Telangana,11 - Criminal Trespass/Burglary_Total (Section 453 to 460 IPC),2988,2889,717,28,6622
Telangana,"11.1 - Criminal Trespass/Burglary (Section 455, 457 & 458 IPC)",1873,1622,484,2,3981
Telangana,"11.2 - House Trespass & House Breaking (Section 453,454,456,459 & 460 IPC)",1115,1267,233,26,2641
Telangana,12 - Theft (Section 379 to 382 IPC),8584,6181,1439,197,16401
Telangana,12.1 - Auto Theft,2382,1558,410,7,4357
Telangana,12.2 - Other Thefts,6202,4623,1029,190,12044
Telangana,"13 - Unlawful Assembly (Section 143,144 & 145)",21,49,4,0,74
Telangana,"14 - Riots (Section 147, 148, 149, 150 & 151 IPC)",1510,1803,938,165,4416
Telangana,14.1 - Communal,54,28,0,0,82
Telangana,14.2 - Industrial,2,7,0,0,9
Telangana,14.3 - Political,113,92,37,0,242
Telangana,14.4 - Caste Conflict,19,12,1,0,32
Telangana,14.4.1 - SC/STs Vs. Non-SCs/STs,2,9,1,0,12
Telangana,14.4.2 - Other Caste Riots,17,3,0,0,20
Telangana,14.5 - Agrarian,0,0,0,0,0
Telangana,14.6 - Students,11,13,3,0,27
Telangana,14.7 - Sectarian,0,0,0,0,0
Telangana,14.8 - Other Riots,1311,1651,897,165,4024
Telangana,15 - Criminal Breach of Trust (Section 406 to 409 IPC),273,576,223,18,1090
Telangana,16 - Cheating (Section 420 IPC),2180,5176,1244,273,8873
Telangana,"17 - Forgery (Section 465, 468 & 471 IPC)",43,101,36,0,180
Telangana,"18 - Counterfeiting (Section 231-235,237-240, 242-243, 255 and 489-A to 489-E IPC)",12,57,18,0,87
Telangana,"18.1 - Offences related to Counterfeit Coin (Section 231-235,237, 238-240 & 242-243 IPC)",0,0,0,0,0
Telangana,18.2 - Counterfeiting Government Stamp (Section 255 IPC),0,0,0,0,0
Telangana,18.3 - Counterfeit currency & Bank notes (Section 489-A to 489-E IPC),12,57,18,0,87
Telangana,18.3.1 - Counterfeiting currency notes or Bank notes (Section 489A IPC),7,30,12,0,49
Telangana,18.3.2 - Using forged or counterfeit currency/Bank notes (Section 489B IPC),3,25,6,0,34
Telangana,18.3.3 - Possession of forged or counterfeiting currency / Bank notes (Section 489C IPC),0,2,0,0,2
Telangana,18.3.4 - Make/Possess materials for forging or counterfeiting currency/Bank notes (Section 489D IPC),2,0,0,0,2
Telangana,18.3.5 - Make/Use documents resembling currency notes/Bank notes (Section 489 E IPC),0,0,0,0,0
Telangana,19 - Arson (Section 435-436 & 438 IPC),173,283,103,29,588
Telangana,"20 - Grievous Hurt (Section 325,326,326A & 326 B IPC)",632,1026,908,120,2686
Telangana,20.1 - Grievous Hurt (Section 325 & 326 IPC),632,1026,908,120,2686
Telangana,20.2 - Acid attack (Section 326A IPC),0,0,0,0,0
Telangana,20.3 - Attempt to Acid Attack (Section 326B IPC),0,0,0,0,0
Telangana,21 - Dowry Deaths (Section 304-B IPC),221,286,166,46,719
Telangana,22 - Assault on women with intent to outrage her Modesty (Section 354 IPC),1922,1625,413,46,4006
Telangana,22.1 - Sexual Harassment (Section 354A IPC),344,290,84,13,731
Telangana,22.2 - Assault on women with intent to Disrobe (Section 354B IPC),86,83,9,3,181
Telangana,22.3 - Voyeurism (Section 354C IPC),26,11,3,0,40
Telangana,22.4 - Stalking (Section 354D IPC),170,207,33,4,414
Telangana,22.5 - Others,1296,1034,284,26,2640
Telangana,23 - Insult to the Modesty of Women (Section 509 IPC),807,380,69,5,1261
Telangana,23.1 - At Office premises,0,0,3,0,3
Telangana,23.2 - Places related to work other than Office,19,19,2,0,40
Telangana,23.3 - In Public Transport system,3,1,0,0,4
Telangana,23.4 - in Other Places,785,360,64,5,1214
Telangana,24 - Cruelty by Husband or his Relatives (Section 498-A IPC),3117,4286,1914,287,9604
Telangana,25 - Importation of Girls from Foreign Country (Section 366-B IPC),0,0,0,0,0
Telangana,26 - Causing Death by Negligence (Section 304-A IPC),2951,3267,1896,274,8388
Telangana,26.1 - Deaths due to negligent driving/act,2912,3196,1882,274,8264
Telangana,26.2 - Deaths due to Other Causes,39,71,14,0,124
Telangana,"27 - Offences against State (Section 121, 121A, 122, 123, 124-A IPC)",0,0,0,0,0
Telangana,27.1 - Sedition (Section 124A IPC),0,0,0,0,0
Telangana,27.2 - Other offences against State,0,0,0,0,0
Telangana,28 - Offences promoting enmity between different groups (Section 153A & 153B IPC),11,2,0,0,13
Telangana,28.1 - Promoting enmity on ground of religion race and place of Birth (Section 153A IPC),11,2,0,0,13
Telangana,28.2 - Imputation & assertions prejudicial to national integration (Section 153B IPC),0,0,0,0,0
Telangana,29 - Extortion (Section 384 - 389 IPC),99,119,24,5,247
Telangana,30 - Disclosure of Identity of Victims (Section 228 A IPC),0,0,0,0,0
Telangana,31 - Incidence of Rash Driving (Section 279 IPC Read with 337 & 338),7535,7095,2240,176,17046
Telangana,32 - Human Trafficking (Section 370 & 370A IPC),10,37,13,0,60
Telangana,33 - Unnatural Offences U/s 377 IPC,5,5,0,0,10
Telangana,34 - Other IPC crimes,16862,22147,12102,2303,53414
Telangana,35 - Total Cognizable IPC crimes,53367,60868,26031,4245,144511
Tripura,1 - Murder (Section 302 IPC),102,65,27,0,194
Tripura,2 - Attempt to commit Murder (Section 307 IPC),54,55,28,1,138
Tripura,3 - Culpable Homicide not amounting to Murder (Section 304 IPC),2,2,0,0,4
Tripura,4 - Attempt to commit Culpable Homicide (Section 308 IPC),0,0,0,0,0
Tripura,5 - Rape (Section 376 IPC),130,64,38,0,232
Tripura,5.1 - Custodial Rape,0,0,0,0,0
Tripura,5.1.1 - Gang Rape,0,0,0,0,0
Tripura,5.1.2 - Other Rape,0,0,0,0,0
Tripura,5.2 - Rape other than Custodial,130,64,38,0,232
Tripura,5.2.1 - Gang Rape,28,4,0,0,32
Tripura,5.2.2 - Other Rape,102,60,38,0,200
Tripura,6 - Attempt to commit Rape (Section 376/511 IPC),19,12,4,0,35
Tripura,"7 - Kidnapping & Abduction_Total (Section 3,364,364A, 366-369 IPC)",98,30,3,0,131
Tripura,7.1 - Kidnapping & Abduction (Section 363 IPC),1,0,0,0,1
Tripura,7.2 - Kidnaping & Abduction in order to Murder (Section 364 IPC),6,2,0,0,8
Tripura,7.3 - Kidnapping for Ransom (Section 364A IPC),0,1,0,0,1
Tripura,7.4 - Kidnapping & Abduction of Women to compel her for marriage (Section 366 IPC),66,17,1,0,84
Tripura,7.5 - Other Kidnapping,25,10,2,0,37
Tripura,"8 - Dacoity (Section 395,396-398 IPC)",1,0,0,0,1
Tripura,8.1 - Dacoity with Murder (Section 396 IPC),1,0,0,0,1
Tripura,8.2 - Other Dacoity,0,0,0,0,0
Tripura,9 - Making Preparation and Assembly for committing Dacoity (Section 399 & 402 IPC),10,2,2,0,14
Tripura,"10 - Robbery (Section 392 to 394, 397 and 398 IPC)",35,11,5,0,51
Tripura,11 - Criminal Trespass/Burglary_Total (Section 453 to 460 IPC),105,51,13,0,169
Tripura,"11.1 - Criminal Trespass/Burglary (Section 455, 457 & 458 IPC)",77,37,9,0,123
Tripura,"11.2 - House Trespass & House Breaking (Section 453,454,456,459 & 460 IPC)",28,14,4,0,46
Tripura,12 - Theft (Section 379 to 382 IPC),135,75,33,1,244
Tripura,12.1 - Auto Theft,13,15,6,0,34
Tripura,12.2 - Other Thefts,122,60,27,1,210
Tripura,"13 - Unlawful Assembly (Section 143,144 & 145)",0,2,2,0,4
Tripura,"14 - Riots (Section 147, 148, 149, 150 & 151 IPC)",146,101,36,4,287
Tripura,14.1 - Communal,0,0,0,0,0
Tripura,14.2 - Industrial,0,0,0,0,0
Tripura,14.3 - Political,30,20,8,2,60
Tripura,14.4 - Caste Conflict,0,0,0,0,0
Tripura,14.4.1 - SC/STs Vs. Non-SCs/STs,0,0,0,0,0
Tripura,14.4.2 - Other Caste Riots,0,0,0,0,0
Tripura,14.5 - Agrarian,0,0,0,0,0
Tripura,14.6 - Students,0,0,0,0,0
Tripura,14.7 - Sectarian,0,0,0,0,0
Tripura,14.8 - Other Riots,116,81,28,2,227
Tripura,15 - Criminal Breach of Trust (Section 406 to 409 IPC),13,27,8,0,48
Tripura,16 - Cheating (Section 420 IPC),25,17,6,0,48
Tripura,"17 - Forgery (Section 465, 468 & 471 IPC)",12,9,6,0,27
Tripura,"18 - Counterfeiting (Section 231-235,237-240, 242-243, 255 and 489-A to 489-E IPC)",5,4,0,0,9
Tripura,"18.1 - Offences related to Counterfeit Coin (Section 231-235,237, 238-240 & 242-243 IPC)",0,0,0,0,0
Tripura,18.2 - Counterfeiting Government Stamp (Section 255 IPC),0,0,0,0,0
Tripura,18.3 - Counterfeit currency & Bank notes (Section 489-A to 489-E IPC),5,4,0,0,9
Tripura,18.3.1 - Counterfeiting currency notes or Bank notes (Section 489A IPC),0,0,0,0,0
Tripura,18.3.2 - Using forged or counterfeit currency/Bank notes (Section 489B IPC),5,1,0,0,6
Tripura,18.3.3 - Possession of forged or counterfeiting currency / Bank notes (Section 489C IPC),0,3,0,0,3
Tripura,18.3.4 - Make/Possess materials for forging or counterfeiting currency/Bank notes (Section 489D IPC),0,0,0,0,0
Tripura,18.3.5 - Make/Use documents resembling currency notes/Bank notes (Section 489 E IPC),0,0,0,0,0
Tripura,19 - Arson (Section 435-436 & 438 IPC),21,12,8,1,42
Tripura,"20 - Grievous Hurt (Section 325,326,326A & 326 B IPC)",886,695,224,7,1812
Tripura,20.1 - Grievous Hurt (Section 325 & 326 IPC),884,693,224,7,1808
Tripura,20.2 - Acid attack (Section 326A IPC),2,2,0,0,4
Tripura,20.3 - Attempt to Acid Attack (Section 326B IPC),0,0,0,0,0
Tripura,21 - Dowry Deaths (Section 304-B IPC),39,43,12,0,94
Tripura,22 - Assault on women with intent to outrage her Modesty (Section 354 IPC),217,171,43,1,432
Tripura,22.1 - Sexual Harassment (Section 354A IPC),38,33,4,0,75
Tripura,22.2 - Assault on women with intent to Disrobe (Section 354B IPC),70,56,19,1,146
Tripura,22.3 - Voyeurism (Section 354C IPC),0,0,0,0,0
Tripura,22.4 - Stalking (Section 354D IPC),0,1,1,0,2
Tripura,22.5 - Others,109,81,19,0,209
Tripura,23 - Insult to the Modesty of Women (Section 509 IPC),7,1,0,0,8
Tripura,23.1 - At Office premises,0,0,0,0,0
Tripura,23.2 - Places related to work other than Office,0,0,0,0,0
Tripura,23.3 - In Public Transport system,0,0,0,0,0
Tripura,23.4 - in Other Places,7,1,0,0,8
Tripura,24 - Cruelty by Husband or his Relatives (Section 498-A IPC),514,400,192,10,1116
Tripura,25 - Importation of Girls from Foreign Country (Section 366-B IPC),0,0,0,0,0
Tripura,26 - Causing Death by Negligence (Section 304-A IPC),86,47,16,0,149
Tripura,26.1 - Deaths due to negligent driving/act,86,46,16,0,148
Tripura,26.2 - Deaths due to Other Causes,0,1,0,0,1
Tripura,"27 - Offences against State (Section 121, 121A, 122, 123, 124-A IPC)",1,0,0,0,1
Tripura,27.1 - Sedition (Section 124A IPC),0,0,0,0,0
Tripura,27.2 - Other offences against State,1,0,0,0,1
Tripura,28 - Offences promoting enmity between different groups (Section 153A & 153B IPC),0,0,0,0,0
Tripura,28.1 - Promoting enmity on ground of religion race and place of Birth (Section 153A IPC),0,0,0,0,0
Tripura,28.2 - Imputation & assertions prejudicial to national integration (Section 153B IPC),0,0,0,0,0
Tripura,29 - Extortion (Section 384 - 389 IPC),8,1,0,0,9
Tripura,30 - Disclosure of Identity of Victims (Section 228 A IPC),0,0,0,0,0
Tripura,31 - Incidence of Rash Driving (Section 279 IPC Read with 337 & 338),264,180,55,0,499
Tripura,32 - Human Trafficking (Section 370 & 370A IPC),0,0,0,0,0
Tripura,33 - Unnatural Offences U/s 377 IPC,3,0,0,0,3
Tripura,34 - Other IPC crimes,349,239,128,6,722
Tripura,35 - Total Cognizable IPC crimes,3287,2316,889,31,6523
Uttar Pradesh,1 - Murder (Section 302 IPC),7558,5216,1782,72,14628
Uttar Pradesh,2 - Attempt to commit Murder (Section 307 IPC),7607,4830,1850,26,14313
Uttar Pradesh,3 - Culpable Homicide not amounting to Murder (Section 304 IPC),1895,1368,449,14,3726
Uttar Pradesh,4 - Attempt to commit Culpable Homicide (Section 308 IPC),673,383,130,1,1187
Uttar Pradesh,5 - Rape (Section 376 IPC),4152,1706,252,5,6115
Uttar Pradesh,5.1 - Custodial Rape,149,116,12,0,277
Uttar Pradesh,5.1.1 - Gang Rape,1,12,0,0,13
Uttar Pradesh,5.1.2 - Other Rape,148,104,12,0,264
Uttar Pradesh,5.2 - Rape other than Custodial,4003,1590,240,5,5838
Uttar Pradesh,5.2.1 - Gang Rape,1149,415,21,0,1585
Uttar Pradesh,5.2.2 - Other Rape,2854,1175,219,5,4253
Uttar Pradesh,6 - Attempt to commit Rape (Section 376/511 IPC),316,105,15,0,436
Uttar Pradesh,"7 - Kidnapping & Abduction_Total (Section 3,364,364A, 366-369 IPC)",17139,7252,1975,34,26400
Uttar Pradesh,7.1 - Kidnapping & Abduction (Section 363 IPC),4134,1379,331,10,5854
Uttar Pradesh,7.2 - Kidnaping & Abduction in order to Murder (Section 364 IPC),514,295,109,0,918
Uttar Pradesh,7.3 - Kidnapping for Ransom (Section 364A IPC),258,132,6,0,396
Uttar Pradesh,7.4 - Kidnapping & Abduction of Women to compel her for marriage (Section 366 IPC),10803,4745,1375,23,16946
Uttar Pradesh,7.5 - Other Kidnapping,1430,701,154,1,2286
Uttar Pradesh,"8 - Dacoity (Section 395,396-398 IPC)",1139,577,79,3,1798
Uttar Pradesh,8.1 - Dacoity with Murder (Section 396 IPC),102,51,9,1,163
Uttar Pradesh,8.2 - Other Dacoity,1037,526,70,2,1635
Uttar Pradesh,9 - Making Preparation and Assembly for committing Dacoity (Section 399 & 402 IPC),269,109,18,1,397
Uttar Pradesh,"10 - Robbery (Section 392 to 394, 397 and 398 IPC)",5305,2180,397,4,7886
Uttar Pradesh,11 - Criminal Trespass/Burglary_Total (Section 453 to 460 IPC),3503,1770,418,3,5694
Uttar Pradesh,"11.1 - Criminal Trespass/Burglary (Section 455, 457 & 458 IPC)",2601,1342,357,3,4303
Uttar Pradesh,"11.2 - House Trespass & House Breaking (Section 453,454,456,459 & 460 IPC)",902,428,61,0,1391
Uttar Pradesh,12 - Theft (Section 379 to 382 IPC),12597,6071,1556,18,20242
Uttar Pradesh,12.1 - Auto Theft,3996,1796,366,1,6159
Uttar Pradesh,12.2 - Other Thefts,8601,4275,1190,17,14083
Uttar Pradesh,"13 - Unlawful Assembly (Section 143,144 & 145)",99,45,9,0,153
Uttar Pradesh,"14 - Riots (Section 147, 148, 149, 150 & 151 IPC)",26429,16143,6018,263,48853
Uttar Pradesh,14.1 - Communal,205,84,30,0,319
Uttar Pradesh,14.2 - Industrial,0,0,0,0,0
Uttar Pradesh,14.3 - Political,54,27,2,0,83
Uttar Pradesh,14.4 - Caste Conflict,230,163,21,0,414
Uttar Pradesh,14.4.1 - SC/STs Vs. Non-SCs/STs,213,144,21,0,378
Uttar Pradesh,14.4.2 - Other Caste Riots,17,19,0,0,36
Uttar Pradesh,14.5 - Agrarian,390,317,98,14,819
Uttar Pradesh,14.6 - Students,63,0,0,0,63
Uttar Pradesh,14.7 - Sectarian,3,4,0,0,7
Uttar Pradesh,14.8 - Other Riots,25484,15548,5867,249,47148
Uttar Pradesh,15 - Criminal Breach of Trust (Section 406 to 409 IPC),3481,2777,1265,50,7573
Uttar Pradesh,16 - Cheating (Section 420 IPC),15122,10827,4318,207,30474
Uttar Pradesh,"17 - Forgery (Section 465, 468 & 471 IPC)",481,681,307,39,1508
Uttar Pradesh,"18 - Counterfeiting (Section 231-235,237-240, 242-243, 255 and 489-A to 489-E IPC)",84,58,6,0,148
Uttar Pradesh,"18.1 - Offences related to Counterfeit Coin (Section 231-235,237, 238-240 & 242-243 IPC)",1,1,0,0,2
Uttar Pradesh,18.2 - Counterfeiting Government Stamp (Section 255 IPC),0,0,0,0,0
Uttar Pradesh,18.3 - Counterfeit currency & Bank notes (Section 489-A to 489-E IPC),83,57,6,0,146
Uttar Pradesh,18.3.1 - Counterfeiting currency notes or Bank notes (Section 489A IPC),53,32,1,0,86
Uttar Pradesh,18.3.2 - Using forged or counterfeit currency/Bank notes (Section 489B IPC),24,20,5,0,49
Uttar Pradesh,18.3.3 - Possession of forged or counterfeiting currency / Bank notes (Section 489C IPC),6,5,0,0,11
Uttar Pradesh,18.3.4 - Make/Possess materials for forging or counterfeiting currency/Bank notes (Section 489D IPC),0,0,0,0,0
Uttar Pradesh,18.3.5 - Make/Use documents resembling currency notes/Bank notes (Section 489 E IPC),0,0,0,0,0
Uttar Pradesh,19 - Arson (Section 435-436 & 438 IPC),253,240,49,1,543
Uttar Pradesh,"20 - Grievous Hurt (Section 325,326,326A & 326 B IPC)",15944,10756,3619,229,30548
Uttar Pradesh,20.1 - Grievous Hurt (Section 325 & 326 IPC),15878,10736,3619,229,30462
Uttar Pradesh,20.2 - Acid attack (Section 326A IPC),51,14,0,0,65
Uttar Pradesh,20.3 - Attempt to Acid Attack (Section 326B IPC),15,6,0,0,21
Uttar Pradesh,21 - Dowry Deaths (Section 304-B IPC),3812,3998,2666,178,10654
Uttar Pradesh,22 - Assault on women with intent to outrage her Modesty (Section 354 IPC),10292,3537,675,9,14513
Uttar Pradesh,22.1 - Sexual Harassment (Section 354A IPC),5047,1714,486,9,7256
Uttar Pradesh,22.2 - Assault on women with intent to Disrobe (Section 354B IPC),1433,572,70,0,2075
Uttar Pradesh,22.3 - Voyeurism (Section 354C IPC),118,13,1,0,132
Uttar Pradesh,22.4 - Stalking (Section 354D IPC),1011,252,50,0,1313
Uttar Pradesh,22.5 - Others,2683,986,68,0,3737
Uttar Pradesh,23 - Insult to the Modesty of Women (Section 509 IPC),22,11,0,0,33
Uttar Pradesh,23.1 - At Office premises,0,0,0,0,0
Uttar Pradesh,23.2 - Places related to work other than Office,2,0,0,0,2
Uttar Pradesh,23.3 - In Public Transport system,5,1,0,0,6
Uttar Pradesh,23.4 - in Other Places,15,10,0,0,25
Uttar Pradesh,24 - Cruelty by Husband or his Relatives (Section 498-A IPC),18336,17468,10154,791,46749
Uttar Pradesh,25 - Importation of Girls from Foreign Country (Section 366-B IPC),0,0,0,0,0
Uttar Pradesh,26 - Causing Death by Negligence (Section 304-A IPC),7537,4156,1265,26,12984
Uttar Pradesh,26.1 - Deaths due to negligent driving/act,7449,4116,1264,26,12855
Uttar Pradesh,26.2 - Deaths due to Other Causes,88,40,1,0,129
Uttar Pradesh,"27 - Offences against State (Section 121, 121A, 122, 123, 124-A IPC)",0,0,0,0,0
Uttar Pradesh,27.1 - Sedition (Section 124A IPC),0,0,0,0,0
Uttar Pradesh,27.2 - Other offences against State,0,0,0,0,0
Uttar Pradesh,28 - Offences promoting enmity between different groups (Section 153A & 153B IPC),24,16,4,0,44
Uttar Pradesh,28.1 - Promoting enmity on ground of religion race and place of Birth (Section 153A IPC),24,16,4,0,44
Uttar Pradesh,28.2 - Imputation & assertions prejudicial to national integration (Section 153B IPC),0,0,0,0,0
Uttar Pradesh,29 - Extortion (Section 384 - 389 IPC),501,397,62,0,960
Uttar Pradesh,30 - Disclosure of Identity of Victims (Section 228 A IPC),0,0,0,0,0
Uttar Pradesh,31 - Incidence of Rash Driving (Section 279 IPC Read with 337 & 338),7208,4174,1466,66,12914
Uttar Pradesh,32 - Human Trafficking (Section 370 & 370A IPC),1,12,0,0,13
Uttar Pradesh,33 - Unnatural Offences U/s 377 IPC,102,41,2,0,145
Uttar Pradesh,34 - Other IPC crimes,90235,47236,19231,1389,158091
Uttar Pradesh,35 - Total Cognizable IPC crimes,262116,154140,60037,3429,479722
Uttarakhand,1 - Murder (Section 302 IPC),169,162,32,0,363
Uttarakhand,2 - Attempt to commit Murder (Section 307 IPC),123,136,16,0,275
Uttarakhand,3 - Culpable Homicide not amounting to Murder (Section 304 IPC),27,27,5,0,59
Uttarakhand,4 - Attempt to commit Culpable Homicide (Section 308 IPC),7,13,3,0,23
Uttarakhand,5 - Rape (Section 376 IPC),171,109,12,2,294
Uttarakhand,5.1 - Custodial Rape,0,0,0,0,0
Uttarakhand,5.1.1 - Gang Rape,0,0,0,0,0
Uttarakhand,5.1.2 - Other Rape,0,0,0,0,0
Uttarakhand,5.2 - Rape other than Custodial,171,109,12,2,294
Uttarakhand,5.2.1 - Gang Rape,2,0,0,0,2
Uttarakhand,5.2.2 - Other Rape,169,109,12,2,292
Uttarakhand,6 - Attempt to commit Rape (Section 376/511 IPC),30,23,3,0,56
Uttarakhand,"7 - Kidnapping & Abduction_Total (Section 3,364,364A, 366-369 IPC)",149,115,13,0,277
Uttarakhand,7.1 - Kidnapping & Abduction (Section 363 IPC),40,28,5,0,73
Uttarakhand,7.2 - Kidnaping & Abduction in order to Murder (Section 364 IPC),6,5,0,0,11
Uttarakhand,7.3 - Kidnapping for Ransom (Section 364A IPC),3,3,0,0,6
Uttarakhand,7.4 - Kidnapping & Abduction of Women to compel her for marriage (Section 366 IPC),5,1,1,0,7
Uttarakhand,7.5 - Other Kidnapping,95,78,7,0,180
Uttarakhand,"8 - Dacoity (Section 395,396-398 IPC)",57,34,3,0,94
Uttarakhand,8.1 - Dacoity with Murder (Section 396 IPC),3,2,0,0,5
Uttarakhand,8.2 - Other Dacoity,54,32,3,0,89
Uttarakhand,9 - Making Preparation and Assembly for committing Dacoity (Section 399 & 402 IPC),3,2,0,0,5
Uttarakhand,"10 - Robbery (Section 392 to 394, 397 and 398 IPC)",138,76,31,0,245
Uttarakhand,11 - Criminal Trespass/Burglary_Total (Section 453 to 460 IPC),223,118,23,0,364
Uttarakhand,"11.1 - Criminal Trespass/Burglary (Section 455, 457 & 458 IPC)",194,104,20,0,318
Uttarakhand,"11.2 - House Trespass & House Breaking (Section 453,454,456,459 & 460 IPC)",29,14,3,0,46
Uttarakhand,12 - Theft (Section 379 to 382 IPC),847,434,59,0,1340
Uttarakhand,12.1 - Auto Theft,309,215,23,0,547
Uttarakhand,12.2 - Other Thefts,538,219,36,0,793
Uttarakhand,"13 - Unlawful Assembly (Section 143,144 & 145)",0,0,0,0,0
Uttarakhand,"14 - Riots (Section 147, 148, 149, 150 & 151 IPC)",616,643,169,10,1438
Uttarakhand,14.1 - Communal,0,2,0,0,2
Uttarakhand,14.2 - Industrial,0,0,0,0,0
Uttarakhand,14.3 - Political,20,20,10,0,50
Uttarakhand,14.4 - Caste Conflict,11,3,0,1,15
Uttarakhand,14.4.1 - SC/STs Vs. Non-SCs/STs,11,3,0,1,15
Uttarakhand,14.4.2 - Other Caste Riots,0,0,0,0,0
Uttarakhand,14.5 - Agrarian,0,0,0,0,0
Uttarakhand,14.6 - Students,43,0,0,0,43
Uttarakhand,14.7 - Sectarian,0,0,0,0,0
Uttarakhand,14.8 - Other Riots,542,618,159,9,1328
Uttarakhand,15 - Criminal Breach of Trust (Section 406 to 409 IPC),15,34,14,0,63
Uttarakhand,16 - Cheating (Section 420 IPC),78,146,47,3,274
Uttarakhand,"17 - Forgery (Section 465, 468 & 471 IPC)",30,56,11,0,97
Uttarakhand,"18 - Counterfeiting (Section 231-235,237-240, 242-243, 255 and 489-A to 489-E IPC)",3,5,0,0,8
Uttarakhand,"18.1 - Offences related to Counterfeit Coin (Section 231-235,237, 238-240 & 242-243 IPC)",0,0,0,0,0
Uttarakhand,18.2 - Counterfeiting Government Stamp (Section 255 IPC),0,0,0,0,0
Uttarakhand,18.3 - Counterfeit currency & Bank notes (Section 489-A to 489-E IPC),3,5,0,0,8
Uttarakhand,18.3.1 - Counterfeiting currency notes or Bank notes (Section 489A IPC),1,0,0,0,1
Uttarakhand,18.3.2 - Using forged or counterfeit currency/Bank notes (Section 489B IPC),0,0,0,0,0
Uttarakhand,18.3.3 - Possession of forged or counterfeiting currency / Bank notes (Section 489C IPC),2,5,0,0,7
Uttarakhand,18.3.4 - Make/Possess materials for forging or counterfeiting currency/Bank notes (Section 489D IPC),0,0,0,0,0
Uttarakhand,18.3.5 - Make/Use documents resembling currency notes/Bank notes (Section 489 E IPC),0,0,0,0,0
Uttarakhand,19 - Arson (Section 435-436 & 438 IPC),2,6,0,0,8
Uttarakhand,"20 - Grievous Hurt (Section 325,326,326A & 326 B IPC)",92,92,5,0,189
Uttarakhand,20.1 - Grievous Hurt (Section 325 & 326 IPC),92,92,5,0,189
Uttarakhand,20.2 - Acid attack (Section 326A IPC),0,0,0,0,0
Uttarakhand,20.3 - Attempt to Acid Attack (Section 326B IPC),0,0,0,0,0
Uttarakhand,21 - Dowry Deaths (Section 304-B IPC),14,31,40,7,92
Uttarakhand,22 - Assault on women with intent to outrage her Modesty (Section 354 IPC),191,158,28,0,377
Uttarakhand,22.1 - Sexual Harassment (Section 354A IPC),13,5,1,0,19
Uttarakhand,22.2 - Assault on women with intent to Disrobe (Section 354B IPC),14,11,0,0,25
Uttarakhand,22.3 - Voyeurism (Section 354C IPC),0,1,0,0,1
Uttarakhand,22.4 - Stalking (Section 354D IPC),8,0,0,0,8
Uttarakhand,22.5 - Others,156,141,27,0,324
Uttarakhand,23 - Insult to the Modesty of Women (Section 509 IPC),2,2,0,0,4
Uttarakhand,23.1 - At Office premises,0,0,0,0,0
Uttarakhand,23.2 - Places related to work other than Office,0,0,0,0,0
Uttarakhand,23.3 - In Public Transport system,0,0,0,0,0
Uttarakhand,23.4 - in Other Places,2,2,0,0,4
Uttarakhand,24 - Cruelty by Husband or his Relatives (Section 498-A IPC),134,172,159,7,472
Uttarakhand,25 - Importation of Girls from Foreign Country (Section 366-B IPC),0,0,0,0,0
Uttarakhand,26 - Causing Death by Negligence (Section 304-A IPC),174,300,55,0,529
Uttarakhand,26.1 - Deaths due to negligent driving/act,173,299,55,0,527
Uttarakhand,26.2 - Deaths due to Other Causes,1,1,0,0,2
Uttarakhand,"27 - Offences against State (Section 121, 121A, 122, 123, 124-A IPC)",0,0,0,0,0
Uttarakhand,27.1 - Sedition (Section 124A IPC),0,0,0,0,0
Uttarakhand,27.2 - Other offences against State,0,0,0,0,0
Uttarakhand,28 - Offences promoting enmity between different groups (Section 153A & 153B IPC),2,2,0,0,4
Uttarakhand,28.1 - Promoting enmity on ground of religion race and place of Birth (Section 153A IPC),2,2,0,0,4
Uttarakhand,28.2 - Imputation & assertions prejudicial to national integration (Section 153B IPC),0,0,0,0,0
Uttarakhand,29 - Extortion (Section 384 - 389 IPC),4,7,0,0,11
Uttarakhand,30 - Disclosure of Identity of Victims (Section 228 A IPC),0,0,0,0,0
Uttarakhand,31 - Incidence of Rash Driving (Section 279 IPC Read with 337 & 338),120,239,14,1,374
Uttarakhand,32 - Human Trafficking (Section 370 & 370A IPC),2,12,2,0,16
Uttarakhand,33 - Unnatural Offences U/s 377 IPC,11,4,1,0,16
Uttarakhand,34 - Other IPC crimes,1624,1888,367,31,3910
Uttarakhand,35 - Total Cognizable IPC crimes,5058,5046,1112,61,11277
West Bengal,1 - Murder (Section 302 IPC),1570,1853,839,23,4285
West Bengal,2 - Attempt to commit Murder (Section 307 IPC),3472,3346,1699,75,8592
West Bengal,3 - Culpable Homicide not amounting to Murder (Section 304 IPC),291,291,81,0,663
West Bengal,4 - Attempt to commit Culpable Homicide (Section 308 IPC),294,315,42,0,651
West Bengal,5 - Rape (Section 376 IPC),1228,989,201,9,2427
West Bengal,5.1 - Custodial Rape,0,0,0,0,0
West Bengal,5.1.1 - Gang Rape,0,0,0,0,0
West Bengal,5.1.2 - Other Rape,0,0,0,0,0
West Bengal,5.2 - Rape other than Custodial,1228,989,201,9,2427
West Bengal,5.2.1 - Gang Rape,161,110,18,0,289
West Bengal,5.2.2 - Other Rape,1067,879,183,9,2138
West Bengal,6 - Attempt to commit Rape (Section 376/511 IPC),1002,665,148,9,1824
West Bengal,"7 - Kidnapping & Abduction_Total (Section 3,364,364A, 366-369 IPC)",3817,3347,837,20,8021
West Bengal,7.1 - Kidnapping & Abduction (Section 363 IPC),1338,1128,311,4,2781
West Bengal,7.2 - Kidnaping & Abduction in order to Murder (Section 364 IPC),39,40,15,0,94
West Bengal,7.3 - Kidnapping for Ransom (Section 364A IPC),70,67,26,0,163
West Bengal,7.4 - Kidnapping & Abduction of Women to compel her for marriage (Section 366 IPC),969,575,124,6,1674
West Bengal,7.5 - Other Kidnapping,1401,1537,361,10,3309
West Bengal,"8 - Dacoity (Section 395,396-398 IPC)",282,294,51,0,627
West Bengal,8.1 - Dacoity with Murder (Section 396 IPC),13,11,0,0,24
West Bengal,8.2 - Other Dacoity,269,283,51,0,603
West Bengal,9 - Making Preparation and Assembly for committing Dacoity (Section 399 & 402 IPC),2678,1478,426,0,4582
West Bengal,"10 - Robbery (Section 392 to 394, 397 and 398 IPC)",488,487,132,1,1108
West Bengal,11 - Criminal Trespass/Burglary_Total (Section 453 to 460 IPC),163,164,39,0,366
West Bengal,"11.1 - Criminal Trespass/Burglary (Section 455, 457 & 458 IPC)",125,132,33,0,290
West Bengal,"11.2 - House Trespass & House Breaking (Section 453,454,456,459 & 460 IPC)",38,32,6,0,76
West Bengal,12 - Theft (Section 379 to 382 IPC),7129,6397,2156,65,15747
West Bengal,12.1 - Auto Theft,1658,1593,344,8,3603
West Bengal,12.2 - Other Thefts,5471,4804,1812,57,12144
West Bengal,"13 - Unlawful Assembly (Section 143,144 & 145)",1429,1018,514,23,2984
West Bengal,"14 - Riots (Section 147, 148, 149, 150 & 151 IPC)",5464,5152,1933,164,12713
West Bengal,14.1 - Communal,47,77,3,0,127
West Bengal,14.2 - Industrial,76,112,30,0,218
West Bengal,14.3 - Political,745,695,75,0,1515
West Bengal,14.4 - Caste Conflict,22,18,0,0,40
West Bengal,14.4.1 - SC/STs Vs. Non-SCs/STs,4,12,0,0,16
West Bengal,14.4.2 - Other Caste Riots,18,6,0,0,24
West Bengal,14.5 - Agrarian,6,75,17,0,98
West Bengal,14.6 - Students,26,0,0,0,26
West Bengal,14.7 - Sectarian,0,0,0,0,0
West Bengal,14.8 - Other Riots,4542,4175,1808,164,10689
West Bengal,15 - Criminal Breach of Trust (Section 406 to 409 IPC),580,1054,438,19,2091
West Bengal,16 - Cheating (Section 420 IPC),2135,3225,1478,46,6884
West Bengal,"17 - Forgery (Section 465, 468 & 471 IPC)",159,306,120,1,586
West Bengal,"18 - Counterfeiting (Section 231-235,237-240, 242-243, 255 and 489-A to 489-E IPC)",283,267,49,0,599
West Bengal,"18.1 - Offences related to Counterfeit Coin (Section 231-235,237, 238-240 & 242-243 IPC)",0,0,0,0,0
West Bengal,18.2 - Counterfeiting Government Stamp (Section 255 IPC),0,0,0,0,0
West Bengal,18.3 - Counterfeit currency & Bank notes (Section 489-A to 489-E IPC),283,267,49,0,599
West Bengal,18.3.1 - Counterfeiting currency notes or Bank notes (Section 489A IPC),88,77,13,0,178
West Bengal,18.3.2 - Using forged or counterfeit currency/Bank notes (Section 489B IPC),169,147,30,0,346
West Bengal,18.3.3 - Possession of forged or counterfeiting currency / Bank notes (Section 489C IPC),18,28,6,0,52
West Bengal,18.3.4 - Make/Possess materials for forging or counterfeiting currency/Bank notes (Section 489D IPC),7,10,0,0,17
West Bengal,18.3.5 - Make/Use documents resembling currency notes/Bank notes (Section 489 E IPC),1,5,0,0,6
West Bengal,19 - Arson (Section 435-436 & 438 IPC),300,304,76,7,687
West Bengal,"20 - Grievous Hurt (Section 325,326,326A & 326 B IPC)",9268,8584,3482,270,21604
West Bengal,20.1 - Grievous Hurt (Section 325 & 326 IPC),9246,8570,3480,269,21565
West Bengal,20.2 - Acid attack (Section 326A IPC),21,12,2,1,36
West Bengal,20.3 - Attempt to Acid Attack (Section 326B IPC),1,2,0,0,3
West Bengal,21 - Dowry Deaths (Section 304-B IPC),342,465,184,0,991
West Bengal,22 - Assault on women with intent to outrage her Modesty (Section 354 IPC),3447,2072,508,9,6036
West Bengal,22.1 - Sexual Harassment (Section 354A IPC),555,306,82,1,944
West Bengal,22.2 - Assault on women with intent to Disrobe (Section 354B IPC),466,180,47,0,693
West Bengal,22.3 - Voyeurism (Section 354C IPC),118,105,15,0,238
West Bengal,22.4 - Stalking (Section 354D IPC),151,115,20,0,286
West Bengal,22.5 - Others,2157,1366,344,8,3875
West Bengal,23 - Insult to the Modesty of Women (Section 509 IPC),462,195,74,0,731
West Bengal,23.1 - At Office premises,2,2,0,0,4
West Bengal,23.2 - Places related to work other than Office,1,5,0,0,6
West Bengal,23.3 - In Public Transport system,5,4,1,0,10
West Bengal,23.4 - in Other Places,454,184,73,0,711
West Bengal,24 - Cruelty by Husband or his Relatives (Section 498-A IPC),11162,13849,6564,586,32161
West Bengal,25 - Importation of Girls from Foreign Country (Section 366-B IPC),4,4,2,0,10
West Bengal,26 - Causing Death by Negligence (Section 304-A IPC),2500,2290,839,18,5647
West Bengal,26.1 - Deaths due to negligent driving/act,2004,1994,708,18,4724
West Bengal,26.2 - Deaths due to Other Causes,496,296,131,0,923
West Bengal,"27 - Offences against State (Section 121, 121A, 122, 123, 124-A IPC)",8,6,1,0,15
West Bengal,27.1 - Sedition (Section 124A IPC),0,0,0,0,0
West Bengal,27.2 - Other offences against State,8,6,1,0,15
West Bengal,28 - Offences promoting enmity between different groups (Section 153A & 153B IPC),6,24,14,0,44
West Bengal,28.1 - Promoting enmity on ground of religion race and place of Birth (Section 153A IPC),6,24,14,0,44
West Bengal,28.2 - Imputation & assertions prejudicial to national integration (Section 153B IPC),0,0,0,0,0
West Bengal,29 - Extortion (Section 384 - 389 IPC),311,176,77,1,565
West Bengal,30 - Disclosure of Identity of Victims (Section 228 A IPC),0,0,0,0,0
West Bengal,31 - Incidence of Rash Driving (Section 279 IPC Read with 337 & 338),4973,4080,1901,79,11033
West Bengal,32 - Human Trafficking (Section 370 & 370A IPC),32,34,19,0,85
West Bengal,33 - Unnatural Offences U/s 377 IPC,8,11,2,0,21
West Bengal,34 - Other IPC crimes,25302,24592,11744,1794,63432
West Bengal,35 - Total Cognizable IPC crimes,90589,87334,36670,3219,217812
A & N Islands,1 - Murder (Section 302 IPC),1,6,2,0,9
A & N Islands,2 - Attempt to commit Murder (Section 307 IPC),12,5,1,0,18
A & N Islands,3 - Culpable Homicide not amounting to Murder (Section 304 IPC),3,3,2,0,8
A & N Islands,4 - Attempt to commit Culpable Homicide (Section 308 IPC),1,1,0,0,2
A & N Islands,5 - Rape (Section 376 IPC),20,10,3,2,35
A & N Islands,5.1 - Custodial Rape,0,0,0,0,0
A & N Islands,5.1.1 - Gang Rape,0,0,0,0,0
A & N Islands,5.1.2 - Other Rape,0,0,0,0,0
A & N Islands,5.2 - Rape other than Custodial,20,10,3,2,35
A & N Islands,5.2.1 - Gang Rape,4,0,0,0,4
A & N Islands,5.2.2 - Other Rape,16,10,3,2,31
A & N Islands,6 - Attempt to commit Rape (Section 376/511 IPC),0,0,0,0,0
A & N Islands,"7 - Kidnapping & Abduction_Total (Section 3,364,364A, 366-369 IPC)",13,7,0,0,20
A & N Islands,7.1 - Kidnapping & Abduction (Section 363 IPC),10,0,0,0,10
A & N Islands,7.2 - Kidnaping & Abduction in order to Murder (Section 364 IPC),0,0,0,0,0
A & N Islands,7.3 - Kidnapping for Ransom (Section 364A IPC),0,0,0,0,0
A & N Islands,7.4 - Kidnapping & Abduction of Women to compel her for marriage (Section 366 IPC),0,0,0,0,0
A & N Islands,7.5 - Other Kidnapping,3,7,0,0,10
A & N Islands,"8 - Dacoity (Section 395,396-398 IPC)",0,0,0,0,0
A & N Islands,8.1 - Dacoity with Murder (Section 396 IPC),0,0,0,0,0
A & N Islands,8.2 - Other Dacoity,0,0,0,0,0
A & N Islands,9 - Making Preparation and Assembly for committing Dacoity (Section 399 & 402 IPC),0,0,0,0,0
A & N Islands,"10 - Robbery (Section 392 to 394, 397 and 398 IPC)",4,2,0,0,6
A & N Islands,11 - Criminal Trespass/Burglary_Total (Section 453 to 460 IPC),22,13,2,0,37
A & N Islands,"11.1 - Criminal Trespass/Burglary (Section 455, 457 & 458 IPC)",16,6,1,0,23
A & N Islands,"11.2 - House Trespass & House Breaking (Section 453,454,456,459 & 460 IPC)",6,7,1,0,14
A & N Islands,12 - Theft (Section 379 to 382 IPC),23,16,2,1,42
A & N Islands,12.1 - Auto Theft,0,1,0,0,1
A & N Islands,12.2 - Other Thefts,23,15,2,1,41
A & N Islands,"13 - Unlawful Assembly (Section 143,144 & 145)",2,5,1,0,8
A & N Islands,"14 - Riots (Section 147, 148, 149, 150 & 151 IPC)",40,21,9,0,70
A & N Islands,14.1 - Communal,0,0,0,0,0
A & N Islands,14.2 - Industrial,0,0,0,0,0
A & N Islands,14.3 - Political,0,0,0,0,0
A & N Islands,14.4 - Caste Conflict,0,0,0,0,0
A & N Islands,14.4.1 - SC/STs Vs. Non-SCs/STs,0,0,0,0,0
A & N Islands,14.4.2 - Other Caste Riots,0,0,0,0,0
A & N Islands,14.5 - Agrarian,0,0,0,0,0
A & N Islands,14.6 - Students,0,0,0,0,0
A & N Islands,14.7 - Sectarian,0,0,0,0,0
A & N Islands,14.8 - Other Riots,40,21,9,0,70
A & N Islands,15 - Criminal Breach of Trust (Section 406 to 409 IPC),2,1,2,0,5
A & N Islands,16 - Cheating (Section 420 IPC),5,13,5,0,23
A & N Islands,"17 - Forgery (Section 465, 468 & 471 IPC)",3,3,1,0,7
A & N Islands,"18 - Counterfeiting (Section 231-235,237-240, 242-243, 255 and 489-A to 489-E IPC)",1,1,0,0,2
A & N Islands,"18.1 - Offences related to Counterfeit Coin (Section 231-235,237, 238-240 & 242-243 IPC)",0,0,0,0,0
A & N Islands,18.2 - Counterfeiting Government Stamp (Section 255 IPC),0,0,0,0,0
A & N Islands,18.3 - Counterfeit currency & Bank notes (Section 489-A to 489-E IPC),1,1,0,0,2
A & N Islands,18.3.1 - Counterfeiting currency notes or Bank notes (Section 489A IPC),0,0,0,0,0
A & N Islands,18.3.2 - Using forged or counterfeit currency/Bank notes (Section 489B IPC),1,1,0,0,2
A & N Islands,18.3.3 - Possession of forged or counterfeiting currency / Bank notes (Section 489C IPC),0,0,0,0,0
A & N Islands,18.3.4 - Make/Possess materials for forging or counterfeiting currency/Bank notes (Section 489D IPC),0,0,0,0,0
A & N Islands,18.3.5 - Make/Use documents resembling currency notes/Bank notes (Section 489 E IPC),0,0,0,0,0
A & N Islands,19 - Arson (Section 435-436 & 438 IPC),1,2,1,1,5
A & N Islands,"20 - Grievous Hurt (Section 325,326,326A & 326 B IPC)",12,14,3,3,32
A & N Islands,20.1 - Grievous Hurt (Section 325 & 326 IPC),12,14,3,3,32
A & N Islands,20.2 - Acid attack (Section 326A IPC),0,0,0,0,0
A & N Islands,20.3 - Attempt to Acid Attack (Section 326B IPC),0,0,0,0,0
A & N Islands,21 - Dowry Deaths (Section 304-B IPC),2,2,2,2,8
A & N Islands,22 - Assault on women with intent to outrage her Modesty (Section 354 IPC),19,14,13,0,46
A & N Islands,22.1 - Sexual Harassment (Section 354A IPC),7,7,6,0,20
A & N Islands,22.2 - Assault on women with intent to Disrobe (Section 354B IPC),0,1,0,0,1
A & N Islands,22.3 - Voyeurism (Section 354C IPC),0,1,0,0,1
A & N Islands,22.4 - Stalking (Section 354D IPC),7,0,0,0,7
A & N Islands,22.5 - Others,5,5,7,0,17
A & N Islands,23 - Insult to the Modesty of Women (Section 509 IPC),4,2,0,0,6
A & N Islands,23.1 - At Office premises,0,0,0,0,0
A & N Islands,23.2 - Places related to work other than Office,0,0,0,0,0
A & N Islands,23.3 - In Public Transport system,0,0,0,0,0
A & N Islands,23.4 - in Other Places,4,2,0,0,6
A & N Islands,24 - Cruelty by Husband or his Relatives (Section 498-A IPC),2,3,2,1,8
A & N Islands,25 - Importation of Girls from Foreign Country (Section 366-B IPC),0,0,0,0,0
A & N Islands,26 - Causing Death by Negligence (Section 304-A IPC),10,16,5,0,31
A & N Islands,26.1 - Deaths due to negligent driving/act,8,11,3,0,22
A & N Islands,26.2 - Deaths due to Other Causes,2,5,2,0,9
A & N Islands,"27 - Offences against State (Section 121, 121A, 122, 123, 124-A IPC)",0,0,0,0,0
A & N Islands,27.1 - Sedition (Section 124A IPC),0,0,0,0,0
A & N Islands,27.2 - Other offences against State,0,0,0,0,0
A & N Islands,28 - Offences promoting enmity between different groups (Section 153A & 153B IPC),0,0,0,1,1
A & N Islands,28.1 - Promoting enmity on ground of religion race and place of Birth (Section 153A IPC),0,0,0,1,1
A & N Islands,28.2 - Imputation & assertions prejudicial to national integration (Section 153B IPC),0,0,0,0,0
A & N Islands,29 - Extortion (Section 384 - 389 IPC),0,0,0,0,0
A & N Islands,30 - Disclosure of Identity of Victims (Section 228 A IPC),0,0,0,0,0
A & N Islands,31 - Incidence of Rash Driving (Section 279 IPC Read with 337 & 338),97,69,35,3,204
A & N Islands,32 - Human Trafficking (Section 370 & 370A IPC),0,0,0,0,0
A & N Islands,33 - Unnatural Offences U/s 377 IPC,1,2,0,0,3
A & N Islands,34 - Other IPC crimes,75,78,37,7,197
A & N Islands,35 - Total Cognizable IPC crimes,375,309,128,21,833
Chandigarh,1 - Murder (Section 302 IPC),22,18,5,0,45
Chandigarh,2 - Attempt to commit Murder (Section 307 IPC),24,34,13,0,71
Chandigarh,3 - Culpable Homicide not amounting to Murder (Section 304 IPC),5,4,2,0,11
Chandigarh,4 - Attempt to commit Culpable Homicide (Section 308 IPC),11,10,3,0,24
Chandigarh,5 - Rape (Section 376 IPC),31,22,9,1,63
Chandigarh,5.1 - Custodial Rape,0,0,0,0,0
Chandigarh,5.1.1 - Gang Rape,0,0,0,0,0
Chandigarh,5.1.2 - Other Rape,0,0,0,0,0
Chandigarh,5.2 - Rape other than Custodial,31,22,9,1,63
Chandigarh,5.2.1 - Gang Rape,0,0,0,0,0
Chandigarh,5.2.2 - Other Rape,31,22,9,1,63
Chandigarh,6 - Attempt to commit Rape (Section 376/511 IPC),1,2,1,0,4
Chandigarh,"7 - Kidnapping & Abduction_Total (Section 3,364,364A, 366-369 IPC)",31,26,7,0,64
Chandigarh,7.1 - Kidnapping & Abduction (Section 363 IPC),6,6,2,0,14
Chandigarh,7.2 - Kidnaping & Abduction in order to Murder (Section 364 IPC),0,0,0,0,0
Chandigarh,7.3 - Kidnapping for Ransom (Section 364A IPC),2,2,0,0,4
Chandigarh,7.4 - Kidnapping & Abduction of Women to compel her for marriage (Section 366 IPC),18,13,4,0,35
Chandigarh,7.5 - Other Kidnapping,5,5,1,0,11
Chandigarh,"8 - Dacoity (Section 395,396-398 IPC)",12,7,0,0,19
Chandigarh,8.1 - Dacoity with Murder (Section 396 IPC),0,0,0,0,0
Chandigarh,8.2 - Other Dacoity,12,7,0,0,19
Chandigarh,9 - Making Preparation and Assembly for committing Dacoity (Section 399 & 402 IPC),12,7,0,0,19
Chandigarh,"10 - Robbery (Section 392 to 394, 397 and 398 IPC)",53,42,32,0,127
Chandigarh,11 - Criminal Trespass/Burglary_Total (Section 453 to 460 IPC),55,57,22,0,134
Chandigarh,"11.1 - Criminal Trespass/Burglary (Section 455, 457 & 458 IPC)",25,28,14,0,67
Chandigarh,"11.2 - House Trespass & House Breaking (Section 453,454,456,459 & 460 IPC)",30,29,8,0,67
Chandigarh,12 - Theft (Section 379 to 382 IPC),305,208,93,0,606
Chandigarh,12.1 - Auto Theft,132,84,52,0,268
Chandigarh,12.2 - Other Thefts,173,124,41,0,338
Chandigarh,"13 - Unlawful Assembly (Section 143,144 & 145)",0,0,0,0,0
Chandigarh,"14 - Riots (Section 147, 148, 149, 150 & 151 IPC)",55,32,9,0,96
Chandigarh,14.1 - Communal,0,0,0,0,0
Chandigarh,14.2 - Industrial,0,0,0,0,0
Chandigarh,14.3 - Political,0,0,0,0,0
Chandigarh,14.4 - Caste Conflict,0,0,0,0,0
Chandigarh,14.4.1 - SC/STs Vs. Non-SCs/STs,0,0,0,0,0
Chandigarh,14.4.2 - Other Caste Riots,0,0,0,0,0
Chandigarh,14.5 - Agrarian,0,0,0,0,0
Chandigarh,14.6 - Students,18,0,0,0,18
Chandigarh,14.7 - Sectarian,0,0,0,0,0
Chandigarh,14.8 - Other Riots,37,32,9,0,78
Chandigarh,15 - Criminal Breach of Trust (Section 406 to 409 IPC),14,12,2,0,28
Chandigarh,16 - Cheating (Section 420 IPC),67,99,49,0,215
Chandigarh,"17 - Forgery (Section 465, 468 & 471 IPC)",0,1,0,0,1
Chandigarh,"18 - Counterfeiting (Section 231-235,237-240, 242-243, 255 and 489-A to 489-E IPC)",0,0,0,0,0
Chandigarh,"18.1 - Offences related to Counterfeit Coin (Section 231-235,237, 238-240 & 242-243 IPC)",0,0,0,0,0
Chandigarh,18.2 - Counterfeiting Government Stamp (Section 255 IPC),0,0,0,0,0
Chandigarh,18.3 - Counterfeit currency & Bank notes (Section 489-A to 489-E IPC),0,0,0,0,0
Chandigarh,18.3.1 - Counterfeiting currency notes or Bank notes (Section 489A IPC),0,0,0,0,0
Chandigarh,18.3.2 - Using forged or counterfeit currency/Bank notes (Section 489B IPC),0,0,0,0,0
Chandigarh,18.3.3 - Possession of forged or counterfeiting currency / Bank notes (Section 489C IPC),0,0,0,0,0
Chandigarh,18.3.4 - Make/Possess materials for forging or counterfeiting currency/Bank notes (Section 489D IPC),0,0,0,0,0
Chandigarh,18.3.5 - Make/Use documents resembling currency notes/Bank notes (Section 489 E IPC),0,0,0,0,0
Chandigarh,19 - Arson (Section 435-436 & 438 IPC),7,6,2,0,15
Chandigarh,"20 - Grievous Hurt (Section 325,326,326A & 326 B IPC)",24,17,4,0,45
Chandigarh,20.1 - Grievous Hurt (Section 325 & 326 IPC),24,17,4,0,45
Chandigarh,20.2 - Acid attack (Section 326A IPC),0,0,0,0,0
Chandigarh,20.3 - Attempt to Acid Attack (Section 326B IPC),0,0,0,0,0
Chandigarh,21 - Dowry Deaths (Section 304-B IPC),2,1,0,0,3
Chandigarh,22 - Assault on women with intent to outrage her Modesty (Section 354 IPC),62,42,13,0,117
Chandigarh,22.1 - Sexual Harassment (Section 354A IPC),18,14,7,0,39
Chandigarh,22.2 - Assault on women with intent to Disrobe (Section 354B IPC),2,2,0,0,4
Chandigarh,22.3 - Voyeurism (Section 354C IPC),3,0,0,0,3
Chandigarh,22.4 - Stalking (Section 354D IPC),7,5,0,0,12
Chandigarh,22.5 - Others,32,21,6,0,59
Chandigarh,23 - Insult to the Modesty of Women (Section 509 IPC),5,0,0,0,5
Chandigarh,23.1 - At Office premises,0,0,0,0,0
Chandigarh,23.2 - Places related to work other than Office,2,0,0,0,2
Chandigarh,23.3 - In Public Transport system,0,0,0,0,0
Chandigarh,23.4 - in Other Places,3,0,0,0,3
Chandigarh,24 - Cruelty by Husband or his Relatives (Section 498-A IPC),63,40,27,0,130
Chandigarh,25 - Importation of Girls from Foreign Country (Section 366-B IPC),0,0,0,0,0
Chandigarh,26 - Causing Death by Negligence (Section 304-A IPC),33,22,12,0,67
Chandigarh,26.1 - Deaths due to negligent driving/act,28,22,12,0,62
Chandigarh,26.2 - Deaths due to Other Causes,5,0,0,0,5
Chandigarh,"27 - Offences against State (Section 121, 121A, 122, 123, 124-A IPC)",0,0,0,0,0
Chandigarh,27.1 - Sedition (Section 124A IPC),0,0,0,0,0
Chandigarh,27.2 - Other offences against State,0,0,0,0,0
Chandigarh,28 - Offences promoting enmity between different groups (Section 153A & 153B IPC),0,0,0,0,0
Chandigarh,28.1 - Promoting enmity on ground of religion race and place of Birth (Section 153A IPC),0,0,0,0,0
Chandigarh,28.2 - Imputation & assertions prejudicial to national integration (Section 153B IPC),0,0,0,0,0
Chandigarh,29 - Extortion (Section 384 - 389 IPC),5,4,0,0,9
Chandigarh,30 - Disclosure of Identity of Victims (Section 228 A IPC),0,0,0,0,0
Chandigarh,31 - Incidence of Rash Driving (Section 279 IPC Read with 337 & 338),104,88,32,0,224
Chandigarh,32 - Human Trafficking (Section 370 & 370A IPC),0,0,0,0,0
Chandigarh,33 - Unnatural Offences U/s 377 IPC,1,2,0,0,3
Chandigarh,34 - Other IPC crimes,238,218,147,0,603
Chandigarh,35 - Total Cognizable IPC crimes,1242,1021,484,1,2748
D&N Haveli,1 - Murder (Section 302 IPC),2,1,0,0,3
D&N Haveli,2 - Attempt to commit Murder (Section 307 IPC),7,4,0,0,11
D&N Haveli,3 - Culpable Homicide not amounting to Murder (Section 304 IPC),3,0,0,0,3
D&N Haveli,4 - Attempt to commit Culpable Homicide (Section 308 IPC),0,0,0,0,0
D&N Haveli,5 - Rape (Section 376 IPC),5,0,0,0,5
D&N Haveli,5.1 - Custodial Rape,0,0,0,0,0
D&N Haveli,5.1.1 - Gang Rape,0,0,0,0,0
D&N Haveli,5.1.2 - Other Rape,0,0,0,0,0
D&N Haveli,5.2 - Rape other than Custodial,5,0,0,0,5
D&N Haveli,5.2.1 - Gang Rape,0,0,0,0,0
D&N Haveli,5.2.2 - Other Rape,5,0,0,0,5
D&N Haveli,6 - Attempt to commit Rape (Section 376/511 IPC),0,0,0,0,0
D&N Haveli,"7 - Kidnapping & Abduction_Total (Section 3,364,364A, 366-369 IPC)",14,6,2,0,22
D&N Haveli,7.1 - Kidnapping & Abduction (Section 363 IPC),14,6,2,0,22
D&N Haveli,7.2 - Kidnaping & Abduction in order to Murder (Section 364 IPC),0,0,0,0,0
D&N Haveli,7.3 - Kidnapping for Ransom (Section 364A IPC),0,0,0,0,0
D&N Haveli,7.4 - Kidnapping & Abduction of Women to compel her for marriage (Section 366 IPC),0,0,0,0,0
D&N Haveli,7.5 - Other Kidnapping,0,0,0,0,0
D&N Haveli,"8 - Dacoity (Section 395,396-398 IPC)",3,0,0,0,3
D&N Haveli,8.1 - Dacoity with Murder (Section 396 IPC),0,0,0,0,0
D&N Haveli,8.2 - Other Dacoity,3,0,0,0,3
D&N Haveli,9 - Making Preparation and Assembly for committing Dacoity (Section 399 & 402 IPC),0,0,0,0,0
D&N Haveli,"10 - Robbery (Section 392 to 394, 397 and 398 IPC)",5,0,0,0,5
D&N Haveli,11 - Criminal Trespass/Burglary_Total (Section 453 to 460 IPC),18,8,0,0,26
D&N Haveli,"11.1 - Criminal Trespass/Burglary (Section 455, 457 & 458 IPC)",6,0,0,0,6
D&N Haveli,"11.2 - House Trespass & House Breaking (Section 453,454,456,459 & 460 IPC)",12,8,0,0,20
D&N Haveli,12 - Theft (Section 379 to 382 IPC),46,15,0,0,61
D&N Haveli,12.1 - Auto Theft,6,1,0,0,7
D&N Haveli,12.2 - Other Thefts,40,14,0,0,54
D&N Haveli,"13 - Unlawful Assembly (Section 143,144 & 145)",0,0,0,0,0
D&N Haveli,"14 - Riots (Section 147, 148, 149, 150 & 151 IPC)",28,16,7,0,51
D&N Haveli,14.1 - Communal,0,0,0,0,0
D&N Haveli,14.2 - Industrial,0,0,0,0,0
D&N Haveli,14.3 - Political,0,0,0,0,0
D&N Haveli,14.4 - Caste Conflict,0,0,0,0,0
D&N Haveli,14.4.1 - SC/STs Vs. Non-SCs/STs,0,0,0,0,0
D&N Haveli,14.4.2 - Other Caste Riots,0,0,0,0,0
D&N Haveli,14.5 - Agrarian,0,0,0,0,0
D&N Haveli,14.6 - Students,0,0,0,0,0
D&N Haveli,14.7 - Sectarian,0,0,0,0,0
D&N Haveli,14.8 - Other Riots,28,16,7,0,51
D&N Haveli,15 - Criminal Breach of Trust (Section 406 to 409 IPC),1,1,0,0,2
D&N Haveli,16 - Cheating (Section 420 IPC),5,17,1,0,23
D&N Haveli,"17 - Forgery (Section 465, 468 & 471 IPC)",0,0,0,0,0
D&N Haveli,"18 - Counterfeiting (Section 231-235,237-240, 242-243, 255 and 489-A to 489-E IPC)",2,0,0,0,2
D&N Haveli,"18.1 - Offences related to Counterfeit Coin (Section 231-235,237, 238-240 & 242-243 IPC)",0,0,0,0,0
D&N Haveli,18.2 - Counterfeiting Government Stamp (Section 255 IPC),0,0,0,0,0
D&N Haveli,18.3 - Counterfeit currency & Bank notes (Section 489-A to 489-E IPC),2,0,0,0,2
D&N Haveli,18.3.1 - Counterfeiting currency notes or Bank notes (Section 489A IPC),0,0,0,0,0
D&N Haveli,18.3.2 - Using forged or counterfeit currency/Bank notes (Section 489B IPC),2,0,0,0,2
D&N Haveli,18.3.3 - Possession of forged or counterfeiting currency / Bank notes (Section 489C IPC),0,0,0,0,0
D&N Haveli,18.3.4 - Make/Possess materials for forging or counterfeiting currency/Bank notes (Section 489D IPC),0,0,0,0,0
D&N Haveli,18.3.5 - Make/Use documents resembling currency notes/Bank notes (Section 489 E IPC),0,0,0,0,0
D&N Haveli,19 - Arson (Section 435-436 & 438 IPC),0,0,0,0,0
D&N Haveli,"20 - Grievous Hurt (Section 325,326,326A & 326 B IPC)",22,7,2,0,31
D&N Haveli,20.1 - Grievous Hurt (Section 325 & 326 IPC),22,7,2,0,31
D&N Haveli,20.2 - Acid attack (Section 326A IPC),0,0,0,0,0
D&N Haveli,20.3 - Attempt to Acid Attack (Section 326B IPC),0,0,0,0,0
D&N Haveli,21 - Dowry Deaths (Section 304-B IPC),0,0,0,0,0
D&N Haveli,22 - Assault on women with intent to outrage her Modesty (Section 354 IPC),1,1,0,0,2
D&N Haveli,22.1 - Sexual Harassment (Section 354A IPC),0,0,0,0,0
D&N Haveli,22.2 - Assault on women with intent to Disrobe (Section 354B IPC),0,0,0,0,0
D&N Haveli,22.3 - Voyeurism (Section 354C IPC),0,0,0,0,0
D&N Haveli,22.4 - Stalking (Section 354D IPC),0,0,0,0,0
D&N Haveli,22.5 - Others,1,1,0,0,2
D&N Haveli,23 - Insult to the Modesty of Women (Section 509 IPC),0,1,0,0,1
D&N Haveli,23.1 - At Office premises,0,0,0,0,0
D&N Haveli,23.2 - Places related to work other than Office,0,0,0,0,0
D&N Haveli,23.3 - In Public Transport system,0,0,0,0,0
D&N Haveli,23.4 - in Other Places,0,1,0,0,1
D&N Haveli,24 - Cruelty by Husband or his Relatives (Section 498-A IPC),2,3,0,0,5
D&N Haveli,25 - Importation of Girls from Foreign Country (Section 366-B IPC),0,0,0,0,0
D&N Haveli,26 - Causing Death by Negligence (Section 304-A IPC),25,27,8,0,60
D&N Haveli,26.1 - Deaths due to negligent driving/act,24,17,4,0,45
D&N Haveli,26.2 - Deaths due to Other Causes,1,10,4,0,15
D&N Haveli,"27 - Offences against State (Section 121, 121A, 122, 123, 124-A IPC)",0,0,0,0,0
D&N Haveli,27.1 - Sedition (Section 124A IPC),0,0,0,0,0
D&N Haveli,27.2 - Other offences against State,0,0,0,0,0
D&N Haveli,28 - Offences promoting enmity between different groups (Section 153A & 153B IPC),0,0,0,0,0
D&N Haveli,28.1 - Promoting enmity on ground of religion race and place of Birth (Section 153A IPC),0,0,0,0,0
D&N Haveli,28.2 - Imputation & assertions prejudicial to national integration (Section 153B IPC),0,0,0,0,0
D&N Haveli,29 - Extortion (Section 384 - 389 IPC),13,3,1,0,17
D&N Haveli,30 - Disclosure of Identity of Victims (Section 228 A IPC),0,0,0,0,0
D&N Haveli,31 - Incidence of Rash Driving (Section 279 IPC Read with 337 & 338),17,14,2,0,33
D&N Haveli,32 - Human Trafficking (Section 370 & 370A IPC),0,0,0,0,0
D&N Haveli,33 - Unnatural Offences U/s 377 IPC,0,0,0,0,0
D&N Haveli,34 - Other IPC crimes,8,20,6,0,34
D&N Haveli,35 - Total Cognizable IPC crimes,227,144,29,0,400
Daman & Diu,1 - Murder (Section 302 IPC),11,7,2,0,20
Daman & Diu,2 - Attempt to commit Murder (Section 307 IPC),5,4,1,1,11
Daman & Diu,3 - Culpable Homicide not amounting to Murder (Section 304 IPC),0,0,0,0,0
Daman & Diu,4 - Attempt to commit Culpable Homicide (Section 308 IPC),0,0,0,0,0
Daman & Diu,5 - Rape (Section 376 IPC),1,1,0,0,2
Daman & Diu,5.1 - Custodial Rape,0,0,0,0,0
Daman & Diu,5.1.1 - Gang Rape,0,0,0,0,0
Daman & Diu,5.1.2 - Other Rape,0,0,0,0,0
Daman & Diu,5.2 - Rape other than Custodial,1,1,0,0,2
Daman & Diu,5.2.1 - Gang Rape,0,0,0,0,0
Daman & Diu,5.2.2 - Other Rape,1,1,0,0,2
Daman & Diu,6 - Attempt to commit Rape (Section 376/511 IPC),0,0,0,0,0
Daman & Diu,"7 - Kidnapping & Abduction_Total (Section 3,364,364A, 366-369 IPC)",4,4,2,0,10
Daman & Diu,7.1 - Kidnapping & Abduction (Section 363 IPC),0,2,0,0,2
Daman & Diu,7.2 - Kidnaping & Abduction in order to Murder (Section 364 IPC),0,0,0,0,0
Daman & Diu,7.3 - Kidnapping for Ransom (Section 364A IPC),0,0,0,0,0
Daman & Diu,7.4 - Kidnapping & Abduction of Women to compel her for marriage (Section 366 IPC),0,0,0,0,0
Daman & Diu,7.5 - Other Kidnapping,4,2,2,0,8
Daman & Diu,"8 - Dacoity (Section 395,396-398 IPC)",0,1,0,0,1
Daman & Diu,8.1 - Dacoity with Murder (Section 396 IPC),0,0,0,0,0
Daman & Diu,8.2 - Other Dacoity,0,1,0,0,1
Daman & Diu,9 - Making Preparation and Assembly for committing Dacoity (Section 399 & 402 IPC),0,1,0,0,1
Daman & Diu,"10 - Robbery (Section 392 to 394, 397 and 398 IPC)",3,3,3,1,10
Daman & Diu,11 - Criminal Trespass/Burglary_Total (Section 453 to 460 IPC),22,3,0,0,25
Daman & Diu,"11.1 - Criminal Trespass/Burglary (Section 455, 457 & 458 IPC)",8,2,0,0,10
Daman & Diu,"11.2 - House Trespass & House Breaking (Section 453,454,456,459 & 460 IPC)",14,1,0,0,15
Daman & Diu,12 - Theft (Section 379 to 382 IPC),7,4,0,0,11
Daman & Diu,12.1 - Auto Theft,5,2,0,0,7
Daman & Diu,12.2 - Other Thefts,2,2,0,0,4
Daman & Diu,"13 - Unlawful Assembly (Section 143,144 & 145)",0,0,0,0,0
Daman & Diu,"14 - Riots (Section 147, 148, 149, 150 & 151 IPC)",29,7,1,0,37
Daman & Diu,14.1 - Communal,0,0,0,0,0
Daman & Diu,14.2 - Industrial,0,0,0,0,0
Daman & Diu,14.3 - Political,0,0,0,0,0
Daman & Diu,14.4 - Caste Conflict,0,0,0,0,0
Daman & Diu,14.4.1 - SC/STs Vs. Non-SCs/STs,0,0,0,0,0
Daman & Diu,14.4.2 - Other Caste Riots,0,0,0,0,0
Daman & Diu,14.5 - Agrarian,0,0,0,0,0
Daman & Diu,14.6 - Students,0,0,0,0,0
Daman & Diu,14.7 - Sectarian,0,0,0,0,0
Daman & Diu,14.8 - Other Riots,29,7,1,0,37
Daman & Diu,15 - Criminal Breach of Trust (Section 406 to 409 IPC),0,0,0,0,0
Daman & Diu,16 - Cheating (Section 420 IPC),39,19,10,1,69
Daman & Diu,"17 - Forgery (Section 465, 468 & 471 IPC)",5,3,3,0,11
Daman & Diu,"18 - Counterfeiting (Section 231-235,237-240, 242-243, 255 and 489-A to 489-E IPC)",0,0,0,0,0
Daman & Diu,"18.1 - Offences related to Counterfeit Coin (Section 231-235,237, 238-240 & 242-243 IPC)",0,0,0,0,0
Daman & Diu,18.2 - Counterfeiting Government Stamp (Section 255 IPC),0,0,0,0,0
Daman & Diu,18.3 - Counterfeit currency & Bank notes (Section 489-A to 489-E IPC),0,0,0,0,0
Daman & Diu,18.3.1 - Counterfeiting currency notes or Bank notes (Section 489A IPC),0,0,0,0,0
Daman & Diu,18.3.2 - Using forged or counterfeit currency/Bank notes (Section 489B IPC),0,0,0,0,0
Daman & Diu,18.3.3 - Possession of forged or counterfeiting currency / Bank notes (Section 489C IPC),0,0,0,0,0
Daman & Diu,18.3.4 - Make/Possess materials for forging or counterfeiting currency/Bank notes (Section 489D IPC),0,0,0,0,0
Daman & Diu,18.3.5 - Make/Use documents resembling currency notes/Bank notes (Section 489 E IPC),0,0,0,0,0
Daman & Diu,19 - Arson (Section 435-436 & 438 IPC),2,0,0,0,2
Daman & Diu,"20 - Grievous Hurt (Section 325,326,326A & 326 B IPC)",11,4,8,0,23
Daman & Diu,20.1 - Grievous Hurt (Section 325 & 326 IPC),11,4,8,0,23
Daman & Diu,20.2 - Acid attack (Section 326A IPC),0,0,0,0,0
Daman & Diu,20.3 - Attempt to Acid Attack (Section 326B IPC),0,0,0,0,0
Daman & Diu,21 - Dowry Deaths (Section 304-B IPC),0,0,0,0,0
Daman & Diu,22 - Assault on women with intent to outrage her Modesty (Section 354 IPC),2,1,0,0,3
Daman & Diu,22.1 - Sexual Harassment (Section 354A IPC),2,1,0,0,3
Daman & Diu,22.2 - Assault on women with intent to Disrobe (Section 354B IPC),0,0,0,0,0
Daman & Diu,22.3 - Voyeurism (Section 354C IPC),0,0,0,0,0
Daman & Diu,22.4 - Stalking (Section 354D IPC),0,0,0,0,0
Daman & Diu,22.5 - Others,0,0,0,0,0
Daman & Diu,23 - Insult to the Modesty of Women (Section 509 IPC),0,0,0,0,0
Daman & Diu,23.1 - At Office premises,0,0,0,0,0
Daman & Diu,23.2 - Places related to work other than Office,0,0,0,0,0
Daman & Diu,23.3 - In Public Transport system,0,0,0,0,0
Daman & Diu,23.4 - in Other Places,0,0,0,0,0
Daman & Diu,24 - Cruelty by Husband or his Relatives (Section 498-A IPC),0,0,0,0,0
Daman & Diu,25 - Importation of Girls from Foreign Country (Section 366-B IPC),0,0,0,0,0
Daman & Diu,26 - Causing Death by Negligence (Section 304-A IPC),4,10,3,0,17
Daman & Diu,26.1 - Deaths due to negligent driving/act,3,6,1,0,10
Daman & Diu,26.2 - Deaths due to Other Causes,1,4,2,0,7
Daman & Diu,"27 - Offences against State (Section 121, 121A, 122, 123, 124-A IPC)",0,0,0,0,0
Daman & Diu,27.1 - Sedition (Section 124A IPC),0,0,0,0,0
Daman & Diu,27.2 - Other offences against State,0,0,0,0,0
Daman & Diu,28 - Offences promoting enmity between different groups (Section 153A & 153B IPC),0,0,0,0,0
Daman & Diu,28.1 - Promoting enmity on ground of religion race and place of Birth (Section 153A IPC),0,0,0,0,0
Daman & Diu,28.2 - Imputation & assertions prejudicial to national integration (Section 153B IPC),0,0,0,0,0
Daman & Diu,29 - Extortion (Section 384 - 389 IPC),3,0,1,0,4
Daman & Diu,30 - Disclosure of Identity of Victims (Section 228 A IPC),0,0,0,0,0
Daman & Diu,31 - Incidence of Rash Driving (Section 279 IPC Read with 337 & 338),16,8,2,0,26
Daman & Diu,32 - Human Trafficking (Section 370 & 370A IPC),0,0,0,0,0
Daman & Diu,33 - Unnatural Offences U/s 377 IPC,0,0,0,0,0
Daman & Diu,34 - Other IPC crimes,28,22,7,0,57
Daman & Diu,35 - Total Cognizable IPC crimes,192,102,43,3,340
Delhi UT,1 - Murder (Section 302 IPC),471,370,67,0,908
Delhi UT,2 - Attempt to commit Murder (Section 307 IPC),672,488,107,3,1270
Delhi UT,3 - Culpable Homicide not amounting to Murder (Section 304 IPC),30,34,9,0,73
Delhi UT,4 - Attempt to commit Culpable Homicide (Section 308 IPC),629,557,133,5,1324
Delhi UT,5 - Rape (Section 376 IPC),1066,783,121,1,1971
Delhi UT,5.1 - Custodial Rape,0,0,0,0,0
Delhi UT,5.1.1 - Gang Rape,0,0,0,0,0
Delhi UT,5.1.2 - Other Rape,0,0,0,0,0
Delhi UT,5.2 - Rape other than Custodial,1066,783,121,1,1971
Delhi UT,5.2.1 - Gang Rape,100,92,8,0,200
Delhi UT,5.2.2 - Other Rape,966,691,113,1,1771
Delhi UT,6 - Attempt to commit Rape (Section 376/511 IPC),49,11,1,0,61
Delhi UT,"7 - Kidnapping & Abduction_Total (Section 3,364,364A, 366-369 IPC)",386,264,48,2,700
Delhi UT,7.1 - Kidnapping & Abduction (Section 363 IPC),328,191,35,1,555
Delhi UT,7.2 - Kidnaping & Abduction in order to Murder (Section 364 IPC),0,0,0,0,0
Delhi UT,7.3 - Kidnapping for Ransom (Section 364A IPC),26,36,4,0,66
Delhi UT,7.4 - Kidnapping & Abduction of Women to compel her for marriage (Section 366 IPC),0,1,0,0,1
Delhi UT,7.5 - Other Kidnapping,32,36,9,1,78
Delhi UT,"8 - Dacoity (Section 395,396-398 IPC)",140,127,0,0,267
Delhi UT,8.1 - Dacoity with Murder (Section 396 IPC),0,1,0,0,1
Delhi UT,8.2 - Other Dacoity,140,126,0,0,266
Delhi UT,9 - Making Preparation and Assembly for committing Dacoity (Section 399 & 402 IPC),0,15,0,0,15
Delhi UT,"10 - Robbery (Section 392 to 394, 397 and 398 IPC)",2857,1670,265,0,4792
Delhi UT,11 - Criminal Trespass/Burglary_Total (Section 453 to 460 IPC),1418,895,176,4,2493
Delhi UT,"11.1 - Criminal Trespass/Burglary (Section 455, 457 & 458 IPC)",803,465,151,3,1422
Delhi UT,"11.2 - House Trespass & House Breaking (Section 453,454,456,459 & 460 IPC)",615,430,25,1,1071
Delhi UT,12 - Theft (Section 379 to 382 IPC),7333,4992,560,60,12945
Delhi UT,12.1 - Auto Theft,2060,1152,122,33,3367
Delhi UT,12.2 - Other Thefts,5273,3840,438,27,9578
Delhi UT,"13 - Unlawful Assembly (Section 143,144 & 145)",0,0,0,0,0
Delhi UT,"14 - Riots (Section 147, 148, 149, 150 & 151 IPC)",219,260,53,6,538
Delhi UT,14.1 - Communal,0,0,0,0,0
Delhi UT,14.2 - Industrial,0,0,0,0,0
Delhi UT,14.3 - Political,0,0,0,0,0
Delhi UT,14.4 - Caste Conflict,9,4,0,0,13
Delhi UT,14.4.1 - SC/STs Vs. Non-SCs/STs,0,0,0,0,0
Delhi UT,14.4.2 - Other Caste Riots,9,4,0,0,13
Delhi UT,14.5 - Agrarian,0,0,0,0,0
Delhi UT,14.6 - Students,15,0,0,0,15
Delhi UT,14.7 - Sectarian,0,0,0,0,0
Delhi UT,14.8 - Other Riots,195,256,53,6,510
Delhi UT,15 - Criminal Breach of Trust (Section 406 to 409 IPC),91,138,20,1,250
Delhi UT,16 - Cheating (Section 420 IPC),382,763,192,18,1355
Delhi UT,"17 - Forgery (Section 465, 468 & 471 IPC)",115,161,77,12,365
Delhi UT,"18 - Counterfeiting (Section 231-235,237-240, 242-243, 255 and 489-A to 489-E IPC)",20,28,4,0,52
Delhi UT,"18.1 - Offences related to Counterfeit Coin (Section 231-235,237, 238-240 & 242-243 IPC)",0,1,0,0,1
Delhi UT,18.2 - Counterfeiting Government Stamp (Section 255 IPC),0,0,0,0,0
Delhi UT,18.3 - Counterfeit currency & Bank notes (Section 489-A to 489-E IPC),20,27,4,0,51
Delhi UT,18.3.1 - Counterfeiting currency notes or Bank notes (Section 489A IPC),2,10,0,0,12
Delhi UT,18.3.2 - Using forged or counterfeit currency/Bank notes (Section 489B IPC),4,1,0,0,5
Delhi UT,18.3.3 - Possession of forged or counterfeiting currency / Bank notes (Section 489C IPC),14,16,4,0,34
Delhi UT,18.3.4 - Make/Possess materials for forging or counterfeiting currency/Bank notes (Section 489D IPC),0,0,0,0,0
Delhi UT,18.3.5 - Make/Use documents resembling currency notes/Bank notes (Section 489 E IPC),0,0,0,0,0
Delhi UT,19 - Arson (Section 435-436 & 438 IPC),35,28,2,0,65
Delhi UT,"20 - Grievous Hurt (Section 325,326,326A & 326 B IPC)",417,289,73,9,788
Delhi UT,20.1 - Grievous Hurt (Section 325 & 326 IPC),401,274,72,9,756
Delhi UT,20.2 - Acid attack (Section 326A IPC),11,9,0,0,20
Delhi UT,20.3 - Attempt to Acid Attack (Section 326B IPC),5,6,1,0,12
Delhi UT,21 - Dowry Deaths (Section 304-B IPC),118,126,44,6,294
Delhi UT,22 - Assault on women with intent to outrage her Modesty (Section 354 IPC),2127,1263,283,14,3687
Delhi UT,22.1 - Sexual Harassment (Section 354A IPC),647,284,85,3,1019
Delhi UT,22.2 - Assault on women with intent to Disrobe (Section 354B IPC),133,152,28,0,313
Delhi UT,22.3 - Voyeurism (Section 354C IPC),14,8,2,0,24
Delhi UT,22.4 - Stalking (Section 354D IPC),232,151,34,1,418
Delhi UT,22.5 - Others,1101,668,134,10,1913
Delhi UT,23 - Insult to the Modesty of Women (Section 509 IPC),590,302,36,4,932
Delhi UT,23.1 - At Office premises,4,4,0,0,8
Delhi UT,23.2 - Places related to work other than Office,11,9,0,0,20
Delhi UT,23.3 - In Public Transport system,4,2,0,0,6
Delhi UT,23.4 - in Other Places,571,287,36,4,898
Delhi UT,24 - Cruelty by Husband or his Relatives (Section 498-A IPC),224,302,41,8,575
Delhi UT,25 - Importation of Girls from Foreign Country (Section 366-B IPC),0,0,0,0,0
Delhi UT,26 - Causing Death by Negligence (Section 304-A IPC),693,434,82,0,1209
Delhi UT,26.1 - Deaths due to negligent driving/act,610,376,63,0,1049
Delhi UT,26.2 - Deaths due to Other Causes,83,58,19,0,160
Delhi UT,"27 - Offences against State (Section 121, 121A, 122, 123, 124-A IPC)",0,0,0,0,0
Delhi UT,27.1 - Sedition (Section 124A IPC),0,0,0,0,0
Delhi UT,27.2 - Other offences against State,0,0,0,0,0
Delhi UT,28 - Offences promoting enmity between different groups (Section 153A & 153B IPC),21,15,0,0,36
Delhi UT,28.1 - Promoting enmity on ground of religion race and place of Birth (Section 153A IPC),21,15,0,0,36
Delhi UT,28.2 - Imputation & assertions prejudicial to national integration (Section 153B IPC),0,0,0,0,0
Delhi UT,29 - Extortion (Section 384 - 389 IPC),92,101,25,0,218
Delhi UT,30 - Disclosure of Identity of Victims (Section 228 A IPC),0,0,0,0,0
Delhi UT,31 - Incidence of Rash Driving (Section 279 IPC Read with 337 & 338),2892,2420,851,31,6194
Delhi UT,32 - Human Trafficking (Section 370 & 370A IPC),0,4,3,0,7
Delhi UT,33 - Unnatural Offences U/s 377 IPC,123,81,14,0,218
Delhi UT,34 - Other IPC crimes,8924,6466,2189,82,17661
Delhi UT,35 - Total Cognizable IPC crimes,32134,23387,5476,266,61263
Lakshadweep,1 - Murder (Section 302 IPC),0,0,0,0,0
Lakshadweep,2 - Attempt to commit Murder (Section 307 IPC),0,0,0,0,0
Lakshadweep,3 - Culpable Homicide not amounting to Murder (Section 304 IPC),0,0,0,0,0
Lakshadweep,4 - Attempt to commit Culpable Homicide (Section 308 IPC),0,0,0,0,0
Lakshadweep,5 - Rape (Section 376 IPC),1,0,0,0,1
Lakshadweep,5.1 - Custodial Rape,0,0,0,0,0
Lakshadweep,5.1.1 - Gang Rape,0,0,0,0,0
Lakshadweep,5.1.2 - Other Rape,0,0,0,0,0
Lakshadweep,5.2 - Rape other than Custodial,1,0,0,0,1
Lakshadweep,5.2.1 - Gang Rape,0,0,0,0,0
Lakshadweep,5.2.2 - Other Rape,1,0,0,0,1
Lakshadweep,6 - Attempt to commit Rape (Section 376/511 IPC),0,0,0,0,0
Lakshadweep,"7 - Kidnapping & Abduction_Total (Section 3,364,364A, 366-369 IPC)",0,0,0,0,0
Lakshadweep,7.1 - Kidnapping & Abduction (Section 363 IPC),0,0,0,0,0
Lakshadweep,7.2 - Kidnaping & Abduction in order to Murder (Section 364 IPC),0,0,0,0,0
Lakshadweep,7.3 - Kidnapping for Ransom (Section 364A IPC),0,0,0,0,0
Lakshadweep,7.4 - Kidnapping & Abduction of Women to compel her for marriage (Section 366 IPC),0,0,0,0,0
Lakshadweep,7.5 - Other Kidnapping,0,0,0,0,0
Lakshadweep,"8 - Dacoity (Section 395,396-398 IPC)",0,0,0,0,0
Lakshadweep,8.1 - Dacoity with Murder (Section 396 IPC),0,0,0,0,0
Lakshadweep,8.2 - Other Dacoity,0,0,0,0,0
Lakshadweep,9 - Making Preparation and Assembly for committing Dacoity (Section 399 & 402 IPC),0,0,0,0,0
Lakshadweep,"10 - Robbery (Section 392 to 394, 397 and 398 IPC)",0,0,0,0,0
Lakshadweep,11 - Criminal Trespass/Burglary_Total (Section 453 to 460 IPC),0,1,0,0,1
Lakshadweep,"11.1 - Criminal Trespass/Burglary (Section 455, 457 & 458 IPC)",0,0,0,0,0
Lakshadweep,"11.2 - House Trespass & House Breaking (Section 453,454,456,459 & 460 IPC)",0,1,0,0,1
Lakshadweep,12 - Theft (Section 379 to 382 IPC),5,6,0,0,11
Lakshadweep,12.1 - Auto Theft,0,0,0,0,0
Lakshadweep,12.2 - Other Thefts,5,6,0,0,11
Lakshadweep,"13 - Unlawful Assembly (Section 143,144 & 145)",5,6,0,0,11
Lakshadweep,"14 - Riots (Section 147, 148, 149, 150 & 151 IPC)",0,14,0,0,14
Lakshadweep,14.1 - Communal,0,0,0,0,0
Lakshadweep,14.2 - Industrial,0,0,0,0,0
Lakshadweep,14.3 - Political,0,14,0,0,14
Lakshadweep,14.4 - Caste Conflict,0,0,0,0,0
Lakshadweep,14.4.1 - SC/STs Vs. Non-SCs/STs,0,0,0,0,0
Lakshadweep,14.4.2 - Other Caste Riots,0,0,0,0,0
Lakshadweep,14.5 - Agrarian,0,0,0,0,0
Lakshadweep,14.6 - Students,0,0,0,0,0
Lakshadweep,14.7 - Sectarian,0,0,0,0,0
Lakshadweep,14.8 - Other Riots,0,0,0,0,0
Lakshadweep,15 - Criminal Breach of Trust (Section 406 to 409 IPC),0,0,0,0,0
Lakshadweep,16 - Cheating (Section 420 IPC),0,0,0,0,0
Lakshadweep,"17 - Forgery (Section 465, 468 & 471 IPC)",0,0,0,0,0
Lakshadweep,"18 - Counterfeiting (Section 231-235,237-240, 242-243, 255 and 489-A to 489-E IPC)",0,0,0,0,0
Lakshadweep,"18.1 - Offences related to Counterfeit Coin (Section 231-235,237, 238-240 & 242-243 IPC)",0,0,0,0,0
Lakshadweep,18.2 - Counterfeiting Government Stamp (Section 255 IPC),0,0,0,0,0
Lakshadweep,18.3 - Counterfeit currency & Bank notes (Section 489-A to 489-E IPC),0,0,0,0,0
Lakshadweep,18.3.1 - Counterfeiting currency notes or Bank notes (Section 489A IPC),0,0,0,0,0
Lakshadweep,18.3.2 - Using forged or counterfeit currency/Bank notes (Section 489B IPC),0,0,0,0,0
Lakshadweep,18.3.3 - Possession of forged or counterfeiting currency / Bank notes (Section 489C IPC),0,0,0,0,0
Lakshadweep,18.3.4 - Make/Possess materials for forging or counterfeiting currency/Bank notes (Section 489D IPC),0,0,0,0,0
Lakshadweep,18.3.5 - Make/Use documents resembling currency notes/Bank notes (Section 489 E IPC),0,0,0,0,0
Lakshadweep,19 - Arson (Section 435-436 & 438 IPC),0,0,0,0,0
Lakshadweep,"20 - Grievous Hurt (Section 325,326,326A & 326 B IPC)",0,0,0,0,0
Lakshadweep,20.1 - Grievous Hurt (Section 325 & 326 IPC),0,0,0,0,0
Lakshadweep,20.2 - Acid attack (Section 326A IPC),0,0,0,0,0
Lakshadweep,20.3 - Attempt to Acid Attack (Section 326B IPC),0,0,0,0,0
Lakshadweep,21 - Dowry Deaths (Section 304-B IPC),0,0,0,0,0
Lakshadweep,22 - Assault on women with intent to outrage her Modesty (Section 354 IPC),0,0,2,0,2
Lakshadweep,22.1 - Sexual Harassment (Section 354A IPC),0,0,0,0,0
Lakshadweep,22.2 - Assault on women with intent to Disrobe (Section 354B IPC),0,0,0,0,0
Lakshadweep,22.3 - Voyeurism (Section 354C IPC),0,0,0,0,0
Lakshadweep,22.4 - Stalking (Section 354D IPC),0,0,0,0,0
Lakshadweep,22.5 - Others,0,0,2,0,2
Lakshadweep,23 - Insult to the Modesty of Women (Section 509 IPC),0,0,0,0,0
Lakshadweep,23.1 - At Office premises,0,0,0,0,0
Lakshadweep,23.2 - Places related to work other than Office,0,0,0,0,0
Lakshadweep,23.3 - In Public Transport system,0,0,0,0,0
Lakshadweep,23.4 - in Other Places,0,0,0,0,0
Lakshadweep,24 - Cruelty by Husband or his Relatives (Section 498-A IPC),0,0,0,0,0
Lakshadweep,25 - Importation of Girls from Foreign Country (Section 366-B IPC),0,0,0,0,0
Lakshadweep,26 - Causing Death by Negligence (Section 304-A IPC),0,0,0,0,0
Lakshadweep,26.1 - Deaths due to negligent driving/act,0,0,0,0,0
Lakshadweep,26.2 - Deaths due to Other Causes,0,0,0,0,0
Lakshadweep,"27 - Offences against State (Section 121, 121A, 122, 123, 124-A IPC)",0,0,0,0,0
Lakshadweep,27.1 - Sedition (Section 124A IPC),0,0,0,0,0
Lakshadweep,27.2 - Other offences against State,0,0,0,0,0
Lakshadweep,28 - Offences promoting enmity between different groups (Section 153A & 153B IPC),0,0,0,0,0
Lakshadweep,28.1 - Promoting enmity on ground of religion race and place of Birth (Section 153A IPC),0,0,0,0,0
Lakshadweep,28.2 - Imputation & assertions prejudicial to national integration (Section 153B IPC),0,0,0,0,0
Lakshadweep,29 - Extortion (Section 384 - 389 IPC),0,0,0,0,0
Lakshadweep,30 - Disclosure of Identity of Victims (Section 228 A IPC),0,0,0,0,0
Lakshadweep,31 - Incidence of Rash Driving (Section 279 IPC Read with 337 & 338),0,0,0,0,0
Lakshadweep,32 - Human Trafficking (Section 370 & 370A IPC),0,0,0,0,0
Lakshadweep,33 - Unnatural Offences U/s 377 IPC,0,0,0,0,0
Lakshadweep,34 - Other IPC crimes,0,8,1,1,10
Lakshadweep,35 - Total Cognizable IPC crimes,11,35,3,1,50
Puducherry,1 - Murder (Section 302 IPC),102,37,9,0,148
Puducherry,2 - Attempt to commit Murder (Section 307 IPC),138,10,18,0,166
Puducherry,3 - Culpable Homicide not amounting to Murder (Section 304 IPC),5,4,0,0,9
Puducherry,4 - Attempt to commit Culpable Homicide (Section 308 IPC),0,0,0,0,0
Puducherry,5 - Rape (Section 376 IPC),4,10,1,0,15
Puducherry,5.1 - Custodial Rape,0,4,1,0,5
Puducherry,5.1.1 - Gang Rape,0,0,0,0,0
Puducherry,5.1.2 - Other Rape,0,4,1,0,5
Puducherry,5.2 - Rape other than Custodial,4,6,0,0,10
Puducherry,5.2.1 - Gang Rape,0,0,0,0,0
Puducherry,5.2.2 - Other Rape,4,6,0,0,10
Puducherry,6 - Attempt to commit Rape (Section 376/511 IPC),0,0,0,0,0
Puducherry,"7 - Kidnapping & Abduction_Total (Section 3,364,364A, 366-369 IPC)",11,4,0,0,15
Puducherry,7.1 - Kidnapping & Abduction (Section 363 IPC),6,0,0,0,6
Puducherry,7.2 - Kidnaping & Abduction in order to Murder (Section 364 IPC),0,0,0,0,0
Puducherry,7.3 - Kidnapping for Ransom (Section 364A IPC),2,4,0,0,6
Puducherry,7.4 - Kidnapping & Abduction of Women to compel her for marriage (Section 366 IPC),1,0,0,0,1
Puducherry,7.5 - Other Kidnapping,2,0,0,0,2
Puducherry,"8 - Dacoity (Section 395,396-398 IPC)",2,6,1,0,9
Puducherry,8.1 - Dacoity with Murder (Section 396 IPC),0,0,0,0,0
Puducherry,8.2 - Other Dacoity,2,6,1,0,9
Puducherry,9 - Making Preparation and Assembly for committing Dacoity (Section 399 & 402 IPC),23,14,0,0,37
Puducherry,"10 - Robbery (Section 392 to 394, 397 and 398 IPC)",1,5,1,0,7
Puducherry,11 - Criminal Trespass/Burglary_Total (Section 453 to 460 IPC),42,23,2,1,68
Puducherry,"11.1 - Criminal Trespass/Burglary (Section 455, 457 & 458 IPC)",33,15,1,0,49
Puducherry,"11.2 - House Trespass & House Breaking (Section 453,454,456,459 & 460 IPC)",9,8,1,1,19
Puducherry,12 - Theft (Section 379 to 382 IPC),148,60,18,2,228
Puducherry,12.1 - Auto Theft,70,26,9,1,106
Puducherry,12.2 - Other Thefts,78,34,9,1,122
Puducherry,"13 - Unlawful Assembly (Section 143,144 & 145)",13,17,27,0,57
Puducherry,"14 - Riots (Section 147, 148, 149, 150 & 151 IPC)",97,85,23,0,205
Puducherry,14.1 - Communal,49,38,19,0,106
Puducherry,14.2 - Industrial,0,0,0,0,0
Puducherry,14.3 - Political,0,21,2,0,23
Puducherry,14.4 - Caste Conflict,17,16,1,0,34
Puducherry,14.4.1 - SC/STs Vs. Non-SCs/STs,6,6,1,0,13
Puducherry,14.4.2 - Other Caste Riots,11,10,0,0,21
Puducherry,14.5 - Agrarian,0,0,0,0,0
Puducherry,14.6 - Students,11,0,0,0,11
Puducherry,14.7 - Sectarian,0,0,0,0,0
Puducherry,14.8 - Other Riots,20,10,1,0,31
Puducherry,15 - Criminal Breach of Trust (Section 406 to 409 IPC),6,4,1,0,11
Puducherry,16 - Cheating (Section 420 IPC),13,41,19,2,75
Puducherry,"17 - Forgery (Section 465, 468 & 471 IPC)",5,16,16,2,39
Puducherry,"18 - Counterfeiting (Section 231-235,237-240, 242-243, 255 and 489-A to 489-E IPC)",0,0,0,0,0
Puducherry,"18.1 - Offences related to Counterfeit Coin (Section 231-235,237, 238-240 & 242-243 IPC)",0,0,0,0,0
Puducherry,18.2 - Counterfeiting Government Stamp (Section 255 IPC),0,0,0,0,0
Puducherry,18.3 - Counterfeit currency & Bank notes (Section 489-A to 489-E IPC),0,0,0,0,0
Puducherry,18.3.1 - Counterfeiting currency notes or Bank notes (Section 489A IPC),0,0,0,0,0
Puducherry,18.3.2 - Using forged or counterfeit currency/Bank notes (Section 489B IPC),0,0,0,0,0
Puducherry,18.3.3 - Possession of forged or counterfeiting currency / Bank notes (Section 489C IPC),0,0,0,0,0
Puducherry,18.3.4 - Make/Possess materials for forging or counterfeiting currency/Bank notes (Section 489D IPC),0,0,0,0,0
Puducherry,18.3.5 - Make/Use documents resembling currency notes/Bank notes (Section 489 E IPC),0,0,0,0,0
Puducherry,19 - Arson (Section 435-436 & 438 IPC),0,0,0,0,0
Puducherry,"20 - Grievous Hurt (Section 325,326,326A & 326 B IPC)",47,61,30,0,138
Puducherry,20.1 - Grievous Hurt (Section 325 & 326 IPC),47,61,30,0,138
Puducherry,20.2 - Acid attack (Section 326A IPC),0,0,0,0,0
Puducherry,20.3 - Attempt to Acid Attack (Section 326B IPC),0,0,0,0,0
Puducherry,21 - Dowry Deaths (Section 304-B IPC),2,1,0,0,3
Puducherry,22 - Assault on women with intent to outrage her Modesty (Section 354 IPC),9,17,9,0,35
Puducherry,22.1 - Sexual Harassment (Section 354A IPC),3,3,1,0,7
Puducherry,22.2 - Assault on women with intent to Disrobe (Section 354B IPC),2,7,1,0,10
Puducherry,22.3 - Voyeurism (Section 354C IPC),0,2,0,0,2
Puducherry,22.4 - Stalking (Section 354D IPC),1,0,0,0,1
Puducherry,22.5 - Others,3,5,7,0,15
Puducherry,23 - Insult to the Modesty of Women (Section 509 IPC),8,8,1,0,17
Puducherry,23.1 - At Office premises,0,4,0,0,4
Puducherry,23.2 - Places related to work other than Office,0,2,0,0,2
Puducherry,23.3 - In Public Transport system,0,0,0,0,0
Puducherry,23.4 - in Other Places,8,2,1,0,11
Puducherry,24 - Cruelty by Husband or his Relatives (Section 498-A IPC),2,2,0,0,4
Puducherry,25 - Importation of Girls from Foreign Country (Section 366-B IPC),0,0,0,0,0
Puducherry,26 - Causing Death by Negligence (Section 304-A IPC),76,98,25,1,200
Puducherry,26.1 - Deaths due to negligent driving/act,73,93,21,0,187
Puducherry,26.2 - Deaths due to Other Causes,3,5,4,1,13
Puducherry,"27 - Offences against State (Section 121, 121A, 122, 123, 124-A IPC)",0,0,0,0,0
Puducherry,27.1 - Sedition (Section 124A IPC),0,0,0,0,0
Puducherry,27.2 - Other offences against State,0,0,0,0,0
Puducherry,28 - Offences promoting enmity between different groups (Section 153A & 153B IPC),0,2,0,0,2
Puducherry,28.1 - Promoting enmity on ground of religion race and place of Birth (Section 153A IPC),0,2,0,0,2
Puducherry,28.2 - Imputation & assertions prejudicial to national integration (Section 153B IPC),0,0,0,0,0
Puducherry,29 - Extortion (Section 384 - 389 IPC),10,2,1,0,13
Puducherry,30 - Disclosure of Identity of Victims (Section 228 A IPC),0,0,1,0,1
Puducherry,31 - Incidence of Rash Driving (Section 279 IPC Read with 337 & 338),416,153,549,6,1124
Puducherry,32 - Human Trafficking (Section 370 & 370A IPC),0,0,0,0,0
Puducherry,33 - Unnatural Offences U/s 377 IPC,0,0,0,0,0
Puducherry,34 - Other IPC crimes,839,614,210,14,1677
Puducherry,35 - Total Cognizable IPC crimes,2019,1294,962,28,4303
Total (States),1 - Murder (Section 302 IPC),28515,27635,10089,785,67024
Total (States),2 - Attempt to commit Murder (Section 307 IPC),36458,31978,13933,1208,83577
Total (States),3 - Culpable Homicide not amounting to Murder (Section 304 IPC),3007,2940,956,61,6964
Total (States),4 - Attempt to commit Culpable Homicide (Section 308 IPC),2520,2367,862,49,5798
Total (States),5 - Rape (Section 376 IPC),25631,14749,3328,249,43957
Total (States),5.1 - Custodial Rape,152,117,12,0,281
Total (States),5.1.1 - Gang Rape,1,12,0,0,13
Total (States),5.1.2 - Other Rape,151,105,12,0,268
Total (States),5.2 - Rape other than Custodial,25479,14632,3316,249,43676
Total (States),5.2.1 - Gang Rape,3119,1293,147,6,4565
Total (States),5.2.2 - Other Rape,22360,13339,3169,243,39111
Total (States),6 - Attempt to commit Rape (Section 376/511 IPC),2545,1445,295,18,4303
Total (States),"7 - Kidnapping & Abduction_Total (Section 3,364,364A, 366-369 IPC)",45399,27616,6518,191,79724
Total (States),7.1 - Kidnapping & Abduction (Section 363 IPC),10157,5366,1163,36,16722
Total (States),7.2 - Kidnaping & Abduction in order to Murder (Section 364 IPC),1222,731,237,15,2205
Total (States),7.3 - Kidnapping for Ransom (Section 364A IPC),762,574,79,3,1418
Total (States),7.4 - Kidnapping & Abduction of Women to compel her for marriage (Section 366 IPC),24160,14013,3509,100,41782
Total (States),7.5 - Other Kidnapping,9098,6932,1530,37,17597
Total (States),"8 - Dacoity (Section 395,396-398 IPC)",9285,6899,1572,84,17840
Total (States),8.1 - Dacoity with Murder (Section 396 IPC),194,121,11,2,328
Total (States),8.2 - Other Dacoity,9091,6778,1561,82,17512
Total (States),9 - Making Preparation and Assembly for committing Dacoity (Section 399 & 402 IPC),7803,3812,817,14,12446
Total (States),"10 - Robbery (Section 392 to 394, 397 and 398 IPC)",27331,14379,3145,109,44964
Total (States),11 - Criminal Trespass/Burglary_Total (Section 453 to 460 IPC),44358,30625,8629,305,83917
Total (States),"11.1 - Criminal Trespass/Burglary (Section 455, 457 & 458 IPC)",32146,21822,6435,212,60615
Total (States),"11.2 - House Trespass & House Breaking (Section 453,454,456,459 & 460 IPC)",12212,8803,2194,93,23302
Total (States),12 - Theft (Section 379 to 382 IPC),127954,85563,21913,1244,236674
Total (States),12.1 - Auto Theft,42092,25577,5202,155,73026
Total (States),12.2 - Other Thefts,85862,59986,16711,1089,163648
Total (States),"13 - Unlawful Assembly (Section 143,144 & 145)",19966,18349,7484,670,46469
Total (States),"14 - Riots (Section 147, 148, 149, 150 & 151 IPC)",138851,119757,42624,4227,305459
Total (States),14.1 - Communal,2700,2355,454,41,5550
Total (States),14.2 - Industrial,286,332,70,0,688
Total (States),14.3 - Political,4407,4394,1398,58,10257
Total (States),14.4 - Caste Conflict,3262,3300,1251,59,7872
Total (States),14.4.1 - SC/STs Vs. Non-SCs/STs,885,848,222,16,1971
Total (States),14.4.2 - Other Caste Riots,2377,2452,1029,43,5901
Total (States),14.5 - Agrarian,1388,1487,599,61,3535
Total (States),14.6 - Students,1241,58,26,4,1329
Total (States),14.7 - Sectarian,29,35,7,0,71
Total (States),14.8 - Other Riots,125538,107796,38819,4004,276157
Total (States),15 - Criminal Breach of Trust (Section 406 to 409 IPC),9423,12610,4707,256,26996
Total (States),16 - Cheating (Section 420 IPC),38456,54081,23800,1937,118274
Total (States),"17 - Forgery (Section 465, 468 & 471 IPC)",2530,4193,1820,209,8752
Total (States),"18 - Counterfeiting (Section 231-235,237-240, 242-243, 255 and 489-A to 489-E IPC)",1041,1177,239,9,2466
Total (States),"18.1 - Offences related to Counterfeit Coin (Section 231-235,237, 238-240 & 242-243 IPC)",145,102,56,5,308
Total (States),18.2 - Counterfeiting Government Stamp (Section 255 IPC),0,2,0,0,2
Total (States),18.3 - Counterfeit currency & Bank notes (Section 489-A to 489-E IPC),896,1073,183,4,2156
Total (States),18.3.1 - Counterfeiting currency notes or Bank notes (Section 489A IPC),410,552,88,3,1053
Total (States),18.3.2 - Using forged or counterfeit currency/Bank notes (Section 489B IPC),375,374,62,0,811
Total (States),18.3.3 - Possession of forged or counterfeiting currency / Bank notes (Section 489C IPC),91,113,27,1,232
Total (States),18.3.4 - Make/Possess materials for forging or counterfeiting currency/Bank notes (Section 489D IPC),13,17,3,0,33
Total (States),18.3.5 - Make/Use documents resembling currency notes/Bank notes (Section 489 E IPC),7,17,3,0,27
Total (States),19 - Arson (Section 435-436 & 438 IPC),4895,7717,1627,116,14355
Total (States),"20 - Grievous Hurt (Section 325,326,326A & 326 B IPC)",82912,71442,29075,2458,185887
Total (States),20.1 - Grievous Hurt (Section 325 & 326 IPC),82738,71367,29064,2455,185624
Total (States),20.2 - Acid attack (Section 326A IPC),143,63,9,3,218
Total (States),20.3 - Attempt to Acid Attack (Section 326B IPC),31,12,2,0,45
Total (States),21 - Dowry Deaths (Section 304-B IPC),8667,8929,5085,551,23232
Total (States),22 - Assault on women with intent to outrage her Modesty (Section 354 IPC),52445,34854,10629,651,98579
Total (States),22.1 - Sexual Harassment (Section 354A IPC),15324,8321,2506,158,26309
Total (States),22.2 - Assault on women with intent to Disrobe (Section 354B IPC),4068,2946,738,66,7818
Total (States),22.3 - Voyeurism (Section 354C IPC),603,282,53,3,941
Total (States),22.4 - Stalking (Section 354D IPC),3108,1439,263,9,4819
Total (States),22.5 - Others,29342,21866,7069,415,58692
Total (States),23 - Insult to the Modesty of Women (Section 509 IPC),5733,3382,692,105,9912
Total (States),23.1 - At Office premises,19,13,10,0,42
Total (States),23.2 - Places related to work other than Office,405,195,14,1,615
Total (States),23.3 - In Public Transport system,85,38,10,0,133
Total (States),23.4 - in Other Places,5224,3136,658,104,9122
Total (States),24 - Cruelty by Husband or his Relatives (Section 498-A IPC),79352,92257,46537,6559,224705
Total (States),25 - Importation of Girls from Foreign Country (Section 366-B IPC),21,18,3,0,42
Total (States),26 - Causing Death by Negligence (Section 304-A IPC),51527,49312,17933,1090,119862
Total (States),26.1 - Deaths due to negligent driving/act,48713,45557,16862,1058,112190
Total (States),26.2 - Deaths due to Other Causes,2814,3755,1071,32,7672
Total (States),"27 - Offences against State (Section 121, 121A, 122, 123, 124-A IPC)",121,90,13,0,224
Total (States),27.1 - Sedition (Section 124A IPC),25,31,2,0,58
Total (States),27.2 - Other offences against State,96,59,11,0,166
Total (States),28 - Offences promoting enmity between different groups (Section 153A & 153B IPC),238,224,128,18,608
Total (States),28.1 - Promoting enmity on ground of religion race and place of Birth (Section 153A IPC),236,219,124,18,597
Total (States),28.2 - Imputation & assertions prejudicial to national integration (Section 153B IPC),2,5,4,0,11
Total (States),29 - Extortion (Section 384 - 389 IPC),4491,3981,898,26,9396
Total (States),30 - Disclosure of Identity of Victims (Section 228 A IPC),0,1,0,0,1
Total (States),31 - Incidence of Rash Driving (Section 279 IPC Read with 337 & 338),174472,149952,56533,3754,384711
Total (States),32 - Human Trafficking (Section 370 & 370A IPC),536,624,148,10,1318
Total (States),33 - Unnatural Offences U/s 377 IPC,514,280,75,9,878
Total (States),34 - Other IPC crimes,614296,538052,233076,23571,1408995
Total (States),35 - Total Cognizable IPC crimes,1651293,1421290,555183,50543,3678309
Total (UTs),1 - Murder (Section 302 IPC),609,439,85,0,1133
Total (UTs),2 - Attempt to commit Murder (Section 307 IPC),858,545,140,4,1547
Total (UTs),3 - Culpable Homicide not amounting to Murder (Section 304 IPC),46,45,13,0,104
Total (UTs),4 - Attempt to commit Culpable Homicide (Section 308 IPC),641,568,136,5,1350
Total (UTs),5 - Rape (Section 376 IPC),1128,826,134,4,2092
Total (UTs),5.1 - Custodial Rape,0,4,1,0,5
Total (UTs),5.1.1 - Gang Rape,0,0,0,0,0
Total (UTs),5.1.2 - Other Rape,0,4,1,0,5
Total (UTs),5.2 - Rape other than Custodial,1128,822,133,4,2087
Total (UTs),5.2.1 - Gang Rape,104,92,8,0,204
Total (UTs),5.2.2 - Other Rape,1024,730,125,4,1883
Total (UTs),6 - Attempt to commit Rape (Section 376/511 IPC),50,13,2,0,65
Total (UTs),"7 - Kidnapping & Abduction_Total (Section 3,364,364A, 366-369 IPC)",459,311,59,2,831
Total (UTs),7.1 - Kidnapping & Abduction (Section 363 IPC),364,205,39,1,609
Total (UTs),7.2 - Kidnaping & Abduction in order to Murder (Section 364 IPC),0,0,0,0,0
Total (UTs),7.3 - Kidnapping for Ransom (Section 364A IPC),30,42,4,0,76
Total (UTs),7.4 - Kidnapping & Abduction of Women to compel her for marriage (Section 366 IPC),19,14,4,0,37
Total (UTs),7.5 - Other Kidnapping,46,50,12,1,109
Total (UTs),"8 - Dacoity (Section 395,396-398 IPC)",157,141,1,0,299
Total (UTs),8.1 - Dacoity with Murder (Section 396 IPC),0,1,0,0,1
Total (UTs),8.2 - Other Dacoity,157,140,1,0,298
Total (UTs),9 - Making Preparation and Assembly for committing Dacoity (Section 399 & 402 IPC),35,37,0,0,72
Total (UTs),"10 - Robbery (Section 392 to 394, 397 and 398 IPC)",2923,1722,301,1,4947
Total (UTs),11 - Criminal Trespass/Burglary_Total (Section 453 to 460 IPC),1577,1000,202,5,2784
Total (UTs),"11.1 - Criminal Trespass/Burglary (Section 455, 457 & 458 IPC)",891,516,167,3,1577
Total (UTs),"11.2 - House Trespass & House Breaking (Section 453,454,456,459 & 460 IPC)",686,484,35,2,1207
Total (UTs),12 - Theft (Section 379 to 382 IPC),7867,5301,673,63,13904
Total (UTs),12.1 - Auto Theft,2273,1266,183,34,3756
Total (UTs),12.2 - Other Thefts,5594,4035,490,29,10148
Total (UTs),"13 - Unlawful Assembly (Section 143,144 & 145)",20,28,28,0,76
Total (UTs),"14 - Riots (Section 147, 148, 149, 150 & 151 IPC)",468,435,102,6,1011
Total (UTs),14.1 - Communal,49,38,19,0,106
Total (UTs),14.2 - Industrial,0,0,0,0,0
Total (UTs),14.3 - Political,0,35,2,0,37
Total (UTs),14.4 - Caste Conflict,26,20,1,0,47
Total (UTs),14.4.1 - SC/STs Vs. Non-SCs/STs,6,6,1,0,13
Total (UTs),14.4.2 - Other Caste Riots,20,14,0,0,34
Total (UTs),14.5 - Agrarian,0,0,0,0,0
Total (UTs),14.6 - Students,44,0,0,0,44
Total (UTs),14.7 - Sectarian,0,0,0,0,0
Total (UTs),14.8 - Other Riots,349,342,80,6,777
Total (UTs),15 - Criminal Breach of Trust (Section 406 to 409 IPC),114,156,25,1,296
Total (UTs),16 - Cheating (Section 420 IPC),511,952,276,21,1760
Total (UTs),"17 - Forgery (Section 465, 468 & 471 IPC)",128,184,97,14,423
Total (UTs),"18 - Counterfeiting (Section 231-235,237-240, 242-243, 255 and 489-A to 489-E IPC)",23,29,4,0,56
Total (UTs),"18.1 - Offences related to Counterfeit Coin (Section 231-235,237, 238-240 & 242-243 IPC)",0,1,0,0,1
Total (UTs),18.2 - Counterfeiting Government Stamp (Section 255 IPC),0,0,0,0,0
Total (UTs),18.3 - Counterfeit currency & Bank notes (Section 489-A to 489-E IPC),23,28,4,0,55
Total (UTs),18.3.1 - Counterfeiting currency notes or Bank notes (Section 489A IPC),2,10,0,0,12
Total (UTs),18.3.2 - Using forged or counterfeit currency/Bank notes (Section 489B IPC),7,2,0,0,9
Total (UTs),18.3.3 - Possession of forged or counterfeiting currency / Bank notes (Section 489C IPC),14,16,4,0,34
Total (UTs),18.3.4 - Make/Possess materials for forging or counterfeiting currency/Bank notes (Section 489D IPC),0,0,0,0,0
Total (UTs),18.3.5 - Make/Use documents resembling currency notes/Bank notes (Section 489 E IPC),0,0,0,0,0
Total (UTs),19 - Arson (Section 435-436 & 438 IPC),45,36,5,1,87
Total (UTs),"20 - Grievous Hurt (Section 325,326,326A & 326 B IPC)",533,392,120,12,1057
Total (UTs),20.1 - Grievous Hurt (Section 325 & 326 IPC),517,377,119,12,1025
Total (UTs),20.2 - Acid attack (Section 326A IPC),11,9,0,0,20
Total (UTs),20.3 - Attempt to Acid Attack (Section 326B IPC),5,6,1,0,12
Total (UTs),21 - Dowry Deaths (Section 304-B IPC),124,130,46,8,308
Total (UTs),22 - Assault on women with intent to outrage her Modesty (Section 354 IPC),2220,1338,320,14,3892
Total (UTs),22.1 - Sexual Harassment (Section 354A IPC),677,309,99,3,1088
Total (UTs),22.2 - Assault on women with intent to Disrobe (Section 354B IPC),137,162,29,0,328
Total (UTs),22.3 - Voyeurism (Section 354C IPC),17,11,2,0,30
Total (UTs),22.4 - Stalking (Section 354D IPC),247,156,34,1,438
Total (UTs),22.5 - Others,1142,700,156,10,2008
Total (UTs),23 - Insult to the Modesty of Women (Section 509 IPC),607,313,37,4,961
Total (UTs),23.1 - At Office premises,4,8,0,0,12
Total (UTs),23.2 - Places related to work other than Office,13,11,0,0,24
Total (UTs),23.3 - In Public Transport system,4,2,0,0,6
Total (UTs),23.4 - in Other Places,586,292,37,4,919
Total (UTs),24 - Cruelty by Husband or his Relatives (Section 498-A IPC),293,350,70,9,722
Total (UTs),25 - Importation of Girls from Foreign Country (Section 366-B IPC),0,0,0,0,0
Total (UTs),26 - Causing Death by Negligence (Section 304-A IPC),841,607,135,1,1584
Total (UTs),26.1 - Deaths due to negligent driving/act,746,525,104,0,1375
Total (UTs),26.2 - Deaths due to Other Causes,95,82,31,1,209
Total (UTs),"27 - Offences against State (Section 121, 121A, 122, 123, 124-A IPC)",0,0,0,0,0
Total (UTs),27.1 - Sedition (Section 124A IPC),0,0,0,0,0
Total (UTs),27.2 - Other offences against State,0,0,0,0,0
Total (UTs),28 - Offences promoting enmity between different groups (Section 153A & 153B IPC),21,17,0,1,39
Total (UTs),28.1 - Promoting enmity on ground of religion race and place of Birth (Section 153A IPC),21,17,0,1,39
Total (UTs),28.2 - Imputation & assertions prejudicial to national integration (Section 153B IPC),0,0,0,0,0
Total (UTs),29 - Extortion (Section 384 - 389 IPC),123,110,28,0,261
Total (UTs),30 - Disclosure of Identity of Victims (Section 228 A IPC),0,0,1,0,1
Total (UTs),31 - Incidence of Rash Driving (Section 279 IPC Read with 337 & 338),3542,2752,1471,40,7805
Total (UTs),32 - Human Trafficking (Section 370 & 370A IPC),0,4,3,0,7
Total (UTs),33 - Unnatural Offences U/s 377 IPC,125,85,14,0,224
Total (UTs),34 - Other IPC crimes,10112,7426,2597,104,20239
Total (UTs),35 - Total Cognizable IPC crimes,36200,26292,7125,320,69937
Total (All India),1 - Murder (Section 302 IPC),29124,28074,10174,785,68157
Total (All India),2 - Attempt to commit Murder (Section 307 IPC),37316,32523,14073,1212,85124
Total (All India),3 - Culpable Homicide not amounting to Murder (Section 304 IPC),3053,2985,969,61,7068
Total (All India),4 - Attempt to commit Culpable Homicide (Section 308 IPC),3161,2935,998,54,7148
Total (All India),5 - Rape (Section 376 IPC),26759,15575,3462,253,46049
Total (All India),5.1 - Custodial Rape,152,121,13,0,286
Total (All India),5.1.1 - Gang Rape,1,12,0,0,13
Total (All India),5.1.2 - Other Rape,151,109,13,0,273
Total (All India),5.2 - Rape other than Custodial,26607,15454,3449,253,45763
Total (All India),5.2.1 - Gang Rape,3223,1385,155,6,4769
Total (All India),5.2.2 - Other Rape,23384,14069,3294,247,40994
Total (All India),6 - Attempt to commit Rape (Section 376/511 IPC),2595,1458,297,18,4368
Total (All India),"7 - Kidnapping & Abduction_Total (Section 3,364,364A, 366-369 IPC)",45858,27927,6577,193,80555
Total (All India),7.1 - Kidnapping & Abduction (Section 363 IPC),10521,5571,1202,37,17331
Total (All India),7.2 - Kidnaping & Abduction in order to Murder (Section 364 IPC),1222,731,237,15,2205
Total (All India),7.3 - Kidnapping for Ransom (Section 364A IPC),792,616,83,3,1494
Total (All India),7.4 - Kidnapping & Abduction of Women to compel her for marriage (Section 366 IPC),24179,14027,3513,100,41819
Total (All India),7.5 - Other Kidnapping,9144,6982,1542,38,17706
Total (All India),"8 - Dacoity (Section 395,396-398 IPC)",9442,7040,1573,84,18139
Total (All India),8.1 - Dacoity with Murder (Section 396 IPC),194,122,11,2,329
Total (All India),8.2 - Other Dacoity,9248,6918,1562,82,17810
Total (All India),9 - Making Preparation and Assembly for committing Dacoity (Section 399 & 402 IPC),7838,3849,817,14,12518
Total (All India),"10 - Robbery (Section 392 to 394, 397 and 398 IPC)",30254,16101,3446,110,49911
Total (All India),11 - Criminal Trespass/Burglary_Total (Section 453 to 460 IPC),45935,31625,8831,310,86701
Total (All India),"11.1 - Criminal Trespass/Burglary (Section 455, 457 & 458 IPC)",33037,22338,6602,215,62192
Total (All India),"11.2 - House Trespass & House Breaking (Section 453,454,456,459 & 460 IPC)",12898,9287,2229,95,24509
Total (All India),12 - Theft (Section 379 to 382 IPC),135821,90864,22586,1307,250578
Total (All India),12.1 - Auto Theft,44365,26843,5385,189,76782
Total (All India),12.2 - Other Thefts,91456,64021,17201,1118,173796
Total (All India),"13 - Unlawful Assembly (Section 143,144 & 145)",19986,18377,7512,670,46545
Total (All India),"14 - Riots (Section 147, 148, 149, 150 & 151 IPC)",139319,120192,42726,4233,306470
Total (All India),14.1 - Communal,2749,2393,473,41,5656
Total (All India),14.2 - Industrial,286,332,70,0,688
Total (All India),14.3 - Political,4407,4429,1400,58,10294
Total (All India),14.4 - Caste Conflict,3288,3320,1252,59,7919
Total (All India),14.4.1 - SC/STs Vs. Non-SCs/STs,891,854,223,16,1984
Total (All India),14.4.2 - Other Caste Riots,2397,2466,1029,43,5935
Total (All India),14.5 - Agrarian,1388,1487,599,61,3535
Total (All India),14.6 - Students,1285,58,26,4,1373
Total (All India),14.7 - Sectarian,29,35,7,0,71
Total (All India),14.8 - Other Riots,125887,108138,38899,4010,276934
Total (All India),15 - Criminal Breach of Trust (Section 406 to 409 IPC),9537,12766,4732,257,27292
Total (All India),16 - Cheating (Section 420 IPC),38967,55033,24076,1958,120034
Total (All India),"17 - Forgery (Section 465, 468 & 471 IPC)",2658,4377,1917,223,9175
Total (All India),"18 - Counterfeiting (Section 231-235,237-240, 242-243, 255 and 489-A to 489-E IPC)",1064,1206,243,9,2522
Total (All India),"18.1 - Offences related to Counterfeit Coin (Section 231-235,237, 238-240 & 242-243 IPC)",145,103,56,5,309
Total (All India),18.2 - Counterfeiting Government Stamp (Section 255 IPC),0,2,0,0,2
Total (All India),18.3 - Counterfeit currency & Bank notes (Section 489-A to 489-E IPC),919,1101,187,4,2211
Total (All India),18.3.1 - Counterfeiting currency notes or Bank notes (Section 489A IPC),412,562,88,3,1065
Total (All India),18.3.2 - Using forged or counterfeit currency/Bank notes (Section 489B IPC),382,376,62,0,820
Total (All India),18.3.3 - Possession of forged or counterfeiting currency / Bank notes (Section 489C IPC),105,129,31,1,266
Total (All India),18.3.4 - Make/Possess materials for forging or counterfeiting currency/Bank notes (Section 489D IPC),13,17,3,0,33
Total (All India),18.3.5 - Make/Use documents resembling currency notes/Bank notes (Section 489 E IPC),7,17,3,0,27
Total (All India),19 - Arson (Section 435-436 & 438 IPC),4940,7753,1632,117,14442
Total (All India),"20 - Grievous Hurt (Section 325,326,326A & 326 B IPC)",83445,71834,29195,2470,186944
Total (All India),20.1 - Grievous Hurt (Section 325 & 326 IPC),83255,71744,29183,2467,186649
Total (All India),20.2 - Acid attack (Section 326A IPC),154,72,9,3,238
Total (All India),20.3 - Attempt to Acid Attack (Section 326B IPC),36,18,3,0,57
Total (All India),21 - Dowry Deaths (Section 304-B IPC),8791,9059,5131,559,23540
Total (All India),22 - Assault on women with intent to outrage her Modesty (Section 354 IPC),54665,36192,10949,665,102471
Total (All India),22.1 - Sexual Harassment (Section 354A IPC),16001,8630,2605,161,27397
Total (All India),22.2 - Assault on women with intent to Disrobe (Section 354B IPC),4205,3108,767,66,8146
Total (All India),22.3 - Voyeurism (Section 354C IPC),620,293,55,3,971
Total (All India),22.4 - Stalking (Section 354D IPC),3355,1595,297,10,5257
Total (All India),22.5 - Others,30484,22566,7225,425,60700
Total (All India),23 - Insult to the Modesty of Women (Section 509 IPC),6340,3695,729,109,10873
Total (All India),23.1 - At Office premises,23,21,10,0,54
Total (All India),23.2 - Places related to work other than Office,418,206,14,1,639
Total (All India),23.3 - In Public Transport system,89,40,10,0,139
Total (All India),23.4 - in Other Places,5810,3428,695,108,10041
Total (All India),24 - Cruelty by Husband or his Relatives (Section 498-A IPC),79645,92607,46607,6568,225427
Total (All India),25 - Importation of Girls from Foreign Country (Section 366-B IPC),21,18,3,0,42
Total (All India),26 - Causing Death by Negligence (Section 304-A IPC),52368,49919,18068,1091,121446
Total (All India),26.1 - Deaths due to negligent driving/act,49459,46082,16966,1058,113565
Total (All India),26.2 - Deaths due to Other Causes,2909,3837,1102,33,7881
Total (All India),"27 - Offences against State (Section 121, 121A, 122, 123, 124-A IPC)",121,90,13,0,224
Total (All India),27.1 - Sedition (Section 124A IPC),25,31,2,0,58
Total (All India),27.2 - Other offences against State,96,59,11,0,166
Total (All India),28 - Offences promoting enmity between different groups (Section 153A & 153B IPC),259,241,128,19,647
Total (All India),28.1 - Promoting enmity on ground of religion race and place of Birth (Section 153A IPC),257,236,124,19,636
Total (All India),28.2 - Imputation & assertions prejudicial to national integration (Section 153B IPC),2,5,4,0,11
Total (All India),29 - Extortion (Section 384 - 389 IPC),4614,4091,926,26,9657
Total (All India),30 - Disclosure of Identity of Victims (Section 228 A IPC),0,1,1,0,2
Total (All India),31 - Incidence of Rash Driving (Section 279 IPC Read with 337 & 338),178014,152704,58004,3794,392516
Total (All India),32 - Human Trafficking (Section 370 & 370A IPC),536,628,151,10,1325
Total (All India),33 - Unnatural Offences U/s 377 IPC,639,365,89,9,1102
Total (All India),34 - Other IPC crimes,624408,545478,235673,23675,1429234
Total (All India),35 - Total Cognizable IPC crimes,1687493,1447582,562308,50863,3748246